child_class	parent_class	file
Session	EventEmitter	app/common/session2.coffee
ShopAchievement	Achievement	app/sdk/achievements/armoryBasedAchievements/bronzeStarterBundleAchievement.coffee
ShopAchievement	Achievement	app/sdk/achievements/armoryBasedAchievements/goldStarterBundleAchievement.coffee
NamasteAchievement	Achievement	app/sdk/achievements/armoryBasedAchievements/namasteAchievement.coffee
ShopAchievement	Achievement	app/sdk/achievements/armoryBasedAchievements/silverStarterBundleAchievement.coffee
WelcomeToCraftingAchievement	Achievement	app/sdk/achievements/craftingBasedAchievements/welcomeToCraftingAchievement.coffee
BloodbornAchievement	Achievement	app/sdk/achievements/factionProgressBasedAchievements/bloodbornAchievement.coffee
WorldExplorerAchievement	Achievement	app/sdk/achievements/factionProgressBasedAchievements/worldExplorerAchievement.coffee
BestOfFriendsAchievement	Achievement	app/sdk/achievements/gameBasedAchievements/bestOfFriendsAchievement.coffee
EnteringGauntletAchievement	Achievement	app/sdk/achievements/gameBasedAchievements/enteringGauntletAchievement.coffee
HelpingHandAchievement	Achievement	app/sdk/achievements/gameBasedAchievements/helpingHandAchievement.coffee
HomeTurfAchievement	Achievement	app/sdk/achievements/gameBasedAchievements/homeTurfAchievement.coffee
TheArtOfWarAchievement	Achievement	app/sdk/achievements/gameBasedAchievements/theArtOfWarAchievement.coffee
CollectorSupremeAchievement	Achievement	app/sdk/achievements/inventoryBasedAchievements/collectorSupremeAchievement.coffee
SisterAchievement	Achievement	app/sdk/achievements/inventoryBasedAchievements/earthSisterAchievement.coffee
FirstCosmeticChestAchievement	Achievement	app/sdk/achievements/inventoryBasedAchievements/firstLootCrateAchievement.coffee
SisterAchievement	Achievement	app/sdk/achievements/inventoryBasedAchievements/lightningSisterAchievement.coffee
SisterAchievement	Achievement	app/sdk/achievements/inventoryBasedAchievements/sandSisterAchievement.coffee
SisterAchievement	Achievement	app/sdk/achievements/inventoryBasedAchievements/shadowSisterAchievement.coffee
SisterAchievement	Achievement	app/sdk/achievements/inventoryBasedAchievements/sunSisterAchievement.coffee
SisterAchievement	Achievement	app/sdk/achievements/inventoryBasedAchievements/swornSisterAchievement.coffee
SisterAchievement	Achievement	app/sdk/achievements/inventoryBasedAchievements/windSisterAchievement.coffee
BNPromoAchievement	Achievement	app/sdk/achievements/loginBasedAchievements/bnPromoAchievement.coffee
ChristmasLoginAchievement	Achievement	app/sdk/achievements/loginBasedAchievements/christmasLoginAchievement.coffee
CoreshatterLoginAchievement	Achievement	app/sdk/achievements/loginBasedAchievements/coreshatterLoginAchievement.coffee
EarlyFeb2018LoginAchievement	Achievement	app/sdk/achievements/loginBasedAchievements/earlyFeb2018LoginAchievement.coffee
FathersDayLoginAchievement	Achievement	app/sdk/achievements/loginBasedAchievements/fathersDayLoginAchievement.coffee
FourthOfJulyLoginAchievement	Achievement	app/sdk/achievements/loginBasedAchievements/fourthOfJulyLoginAchievement.coffee
Frostfire2017BonusLoginAchievement	Achievement	app/sdk/achievements/loginBasedAchievements/frostfire2017BonusLoginAchievement.coffee
Frostfire2017LoginAchievement	Achievement	app/sdk/achievements/loginBasedAchievements/frostfire2017LoginAchievement.coffee
HalloweenLoginAchievement	Achievement	app/sdk/achievements/loginBasedAchievements/halloweenLoginAchievement.coffee
LaborDayLoginAchievement	Achievement	app/sdk/achievements/loginBasedAchievements/laborDayLoginAchievement.coffee
MemorialDayLoginAchievement	Achievement	app/sdk/achievements/loginBasedAchievements/memorialDayLoginAchievement.coffee
MidAugLoginAchievement	Achievement	app/sdk/achievements/loginBasedAchievements/midAugLoginAchievement.coffee
MidNov2017LoginAchievement	Achievement	app/sdk/achievements/loginBasedAchievements/midNov2017LoginAchievement.coffee
NewPlayerGoldLoginAchievement	Achievement	app/sdk/achievements/loginBasedAchievements/newPlayerGoldLoginAchievement.coffee
NewPlayerSpiritLoginAchievement	Achievement	app/sdk/achievements/loginBasedAchievements/newPlayerSpiritLoginAchievement.coffee
SummerLoginAchievement	Achievement	app/sdk/achievements/loginBasedAchievements/summerLoginAchievement.coffee
ThanksgivingLoginAchievement	Achievement	app/sdk/achievements/loginBasedAchievements/thanksgivingLoginAchievement.coffee
MythronOrb1Achievement	Achievement	app/sdk/achievements/orbOpeningAchievements/mythronOrb1Achievement.coffee
MythronOrb2Achievement	Achievement	app/sdk/achievements/orbOpeningAchievements/mythronOrb2Achievement.coffee
MythronOrb3Achievement	Achievement	app/sdk/achievements/orbOpeningAchievements/mythronOrb3Achievement.coffee
MythronOrb4Achievement	Achievement	app/sdk/achievements/orbOpeningAchievements/mythronOrb4Achievement.coffee
MythronOrb5Achievement	Achievement	app/sdk/achievements/orbOpeningAchievements/mythronOrb5Achievement.coffee
MythronOrb6Achievement	Achievement	app/sdk/achievements/orbOpeningAchievements/mythronOrb6Achievement.coffee
MythronOrb7Achievement	Achievement	app/sdk/achievements/orbOpeningAchievements/mythronOrb7Achievement.coffee
EpicQuestorAchievement	Achievement	app/sdk/achievements/questBasedAchievements/epicQuestorAchievement.coffee
IndomitableSpiritAchievement	Achievement	app/sdk/achievements/questBasedAchievements/indomitableSpiritAchievement.coffee
JourneymanQuestorAchievement	Achievement	app/sdk/achievements/questBasedAchievements/journeymanQuestorAchievement.coffee
LegendaryQuestorAchievement	Achievement	app/sdk/achievements/questBasedAchievements/legendaryQuestorAchievement.coffee
SilverDivisionAchievement	Achievement	app/sdk/achievements/rankBasedAchievements/silverDivisionAchievement.coffee
FirstReferralPurchase	Achievement	app/sdk/achievements/referralBasedAchievements/firstReferralPurchaseAchievement.coffee
WartechGeneralFaction1Achievement	Achievement	app/sdk/achievements/wartechAchievements/wartechGeneralFaction1Achievement.coffee
WartechGeneralFaction2Achievement	Achievement	app/sdk/achievements/wartechAchievements/wartechGeneralFaction2Achievement.coffee
WartechGeneralFaction3Achievement	Achievement	app/sdk/achievements/wartechAchievements/wartechGeneralFaction3Achievement.coffee
WartechGeneralFaction4Achievement	Achievement	app/sdk/achievements/wartechAchievements/wartechGeneralFaction4Achievement.coffee
WartechGeneralFaction5Achievement	Achievement	app/sdk/achievements/wartechAchievements/wartechGeneralFaction5Achievement.coffee
WartechGeneralFaction6Achievement	Achievement	app/sdk/achievements/wartechAchievements/wartechGeneralFaction6Achievement.coffee
Action	SDKObject	app/sdk/actions/action.coffee
ActivateSignatureCardAction	Action	app/sdk/actions/activateSignatureCardAction.coffee
ApplyCardToBoardAction	Action	app/sdk/actions/applyCardToBoardAction.coffee
ApplyExhaustionAction	Action	app/sdk/actions/applyExhaustionAction.coffee
ApplyModifierAction	Action	app/sdk/actions/applyModifierAction.coffee
AttackAction	DamageAction	app/sdk/actions/attackAction.coffee
BonusManaAction	Action	app/sdk/actions/bonusManaAction.coffee
BonusManaCoreAction	Action	app/sdk/actions/bonusManaCoreAction.coffee
BurnCardAction	DrawCardAction	app/sdk/actions/burnCardAction.coffee
CloneEntityAction	PlayCardSilentlyAction	app/sdk/actions/cloneEntityAction.coffee
CloneEntityAsTransformAction	CloneEntityAction	app/sdk/actions/cloneEntityAsTransformAction.coffee
DamageAction	Action	app/sdk/actions/damageAction.coffee
DamageAsAttackAction	DamageAction	app/sdk/actions/damageAsAttackAction.coffee
DieAction	RemoveAction	app/sdk/actions/dieAction.coffee
DrawCardAction	PutCardInHandAction	app/sdk/actions/drawCardAction.coffee
DrawStartingHandAction	Action	app/sdk/actions/drawStartingHandAction.coffee
DrawToXCardsAction	Action	app/sdk/actions/drawToXCardsAction.coffee
EndFollowupAction	StopBufferingEventsAction	app/sdk/actions/endFollowupAction.coffee
EndTurnAction	Action	app/sdk/actions/endTurnAction.coffee
FightAction	Action	app/sdk/actions/fightAction.coffee
ForcedAttackAction	AttackAction	app/sdk/actions/forcedAttackAction.coffee
GenerateSignatureCardAction	Action	app/sdk/actions/generateSignatureCardAction.coffee
HealAction	Action	app/sdk/actions/healAction.coffee
HurtingDamageAction	TrueDamageAction	app/sdk/actions/hurtingDamageAction.coffee
KillAction	Action	app/sdk/actions/killAction.coffee
MoveAction	Action	app/sdk/actions/moveAction.coffee
PlayCardAction	ApplyCardToBoardAction	app/sdk/actions/playCardAction.coffee
PlayCardAsTransformAction	PlayCardSilentlyAction	app/sdk/actions/playCardAsTransformAction.coffee
PlayCardFromHandAction	PlayCardAction	app/sdk/actions/playCardFromHandAction.coffee
PlayCardSilentlyAction	ApplyCardToBoardAction	app/sdk/actions/playCardSilentlyAction.coffee
PlaySignatureCardAction	PlayCardAction	app/sdk/actions/playSignatureCardAction.coffee
PutCardInDeckAction	Action	app/sdk/actions/putCardInDeckAction.coffee
PutCardInHandAction	Action	app/sdk/actions/putCardInHandAction.coffee
RandomDamageAction	DamageAction	app/sdk/actions/randomDamageAction.coffee
RandomPlayCardSilentlyAction	PlayCardSilentlyAction	app/sdk/actions/randomPlayCardSilentlyAction.coffee
RandomTeleportAction	TeleportAction	app/sdk/actions/randomTeleportAction.coffee
RefreshArtifactChargesAction	Action	app/sdk/actions/refreshArtifactChargesAction.coffee
RefreshExhaustionAction	Action	app/sdk/actions/refreshExhaustionAction.coffee
RemoveAction	Action	app/sdk/actions/removeAction.coffee
RemoveArtifactsAction	Action	app/sdk/actions/removeArtifactsAction.coffee
RemoveCardFromDeckAction	Action	app/sdk/actions/removeCardFromDeckAction.coffee
RemoveCardFromHandAction	Action	app/sdk/actions/removeCardFromHandAction.coffee
RemoveManaCoreAction	Action	app/sdk/actions/removeManaCoreAction.coffee
RemoveModifierAction	Action	app/sdk/actions/removeModifierAction.coffee
RemoveRandomArtifactAction	Action	app/sdk/actions/removeRandomArtifactAction.coffee
ReplaceCardFromHandAction	PutCardInHandAction	app/sdk/actions/replaceCardFromHandAction.coffee
ResignAction	DieAction	app/sdk/actions/resignAction.coffee
RestoreChargeToAllArtifactsAction	Action	app/sdk/actions/restoreChargeToAllArtifactsAction.coffee
RestoreManaAction	Action	app/sdk/actions/restoreManaAction.coffee
RevealHiddenCardAction	Action	app/sdk/actions/revealHiddenCardAction.coffee
RollbackToSnapshotAction	Action	app/sdk/actions/rollbackToSnapshotAction.coffee
SetDamageAction	Action	app/sdk/actions/setDamageAction.coffee
SetExhaustionAction	Action	app/sdk/actions/setExhaustionAction.coffee
StartTurnAction	Action	app/sdk/actions/startTurnAction.coffee
StopBufferingEventsAction	Action	app/sdk/actions/stopBufferingEventsAction.coffee
SwapGeneralAction	Action	app/sdk/actions/swapGeneralAction.coffee
SwapUnitAllegianceAction	Action	app/sdk/actions/swapUnitAllegianceAction.coffee
SwapUnitsAction	Action	app/sdk/actions/swapUnitsAction.coffee
TakeAnotherTurnAction	Action	app/sdk/actions/takeAnotherTurnAction.coffee
TeleportAction	Action	app/sdk/actions/teleportAction.coffee
TeleportBehindUnitAction	TeleportAction	app/sdk/actions/teleportBehindUnitAction.coffee
TeleportInFrontOfUnitAction	TeleportAction	app/sdk/actions/teleportInFrontOfUnitAction.coffee
TrueDamageAction	DamageAction	app/sdk/actions/trueDamageAction.coffee
UpdateSignatureCardAction	Action	app/sdk/actions/updateSignatureCardAction.coffee
StaticAgent	BaseAgent	app/sdk/agents/staticAgent.coffee
Artifact	Card	app/sdk/artifacts/artifact.coffee
BattleMapTemplate	SDKObject	app/sdk/battleMapTemplate.coffee
Board	SDKObject	app/sdk/board.coffee
Card	SDKObject	app/sdk/cards/card.coffee
Deck	SDKObject	app/sdk/cards/deck.coffee
AdvancedAbyssianChallenge1	Challenge	app/sdk/challenges/abyssian/AdvancedAbyssianChallenge1.coffee
BeginnerAbyssianChallenge1	Challenge	app/sdk/challenges/abyssian/BeginnerAbyssianChallenge1.coffee
BeginnerAbyssianChallenge2	Challenge	app/sdk/challenges/abyssian/BeginnerAbyssianChallenge2.coffee
BeginnerAbyssianChallenge3	Challenge	app/sdk/challenges/abyssian/BeginnerAbyssianChallenge3.coffee
BeginnerAbyssianChallenge4	Challenge	app/sdk/challenges/abyssian/BeginnerAbyssianChallenge4.coffee
BeginnerAbyssianChallenge5	Challenge	app/sdk/challenges/abyssian/BeginnerAbyssianChallenge5.coffee
BeginnerAbyssianChallenge6	Challenge	app/sdk/challenges/abyssian/BeginnerAbyssianChallenge6.coffee
MediumAbyssianChallenge1	Challenge	app/sdk/challenges/abyssian/MediumAbyssianChallenge1.coffee
ChallengeRemote	Challenge	app/sdk/challenges/challengeRemote.coffee
Instruction	Validator	app/sdk/challenges/instruction.coffee
AdvancedLyonarChallenge1	Challenge	app/sdk/challenges/lyonar/AdvancedLyonarChallenge1.coffee
AdvancedLyonarChallenge2	Challenge	app/sdk/challenges/lyonar/AdvancedLyonarChallenge2.coffee
BeginnerLyonarChallenge1	Challenge	app/sdk/challenges/lyonar/BeginnerLyonarChallenge1.coffee
BeginnerLyonarChallenge2	Challenge	app/sdk/challenges/lyonar/BeginnerLyonarChallenge2.coffee
BeginnerLyonarChallenge3	Challenge	app/sdk/challenges/lyonar/BeginnerLyonarChallenge3.coffee
BeginnerLyonarChallenge4	Challenge	app/sdk/challenges/lyonar/BeginnerLyonarChallenge4.coffee
AdvancedMagmarChallenge1	Challenge	app/sdk/challenges/magmar/AdvancedMagmarChallenge1.coffee
BeginnerMagmarChallenge1	Challenge	app/sdk/challenges/magmar/BeginnerMagmarChallenge1.coffee
BeginnerMagmarChallenge2	Challenge	app/sdk/challenges/magmar/BeginnerMagmarChallenge2.coffee
BeginnerMagmarChallenge3	Challenge	app/sdk/challenges/magmar/BeginnerMagmarChallenge3.coffee
BeginnerMagmarChallenge4	Challenge	app/sdk/challenges/magmar/BeginnerMagmarChallenge4.coffee
MediumMagmarChallenge1	Challenge	app/sdk/challenges/magmar/MediumMagmarChallenge1.coffee
Sandbox	Challenge	app/sdk/challenges/sandbox.coffee
SandboxDeveloper	Sandbox	app/sdk/challenges/sandboxDeveloper.coffee
AdvancedSonghaiChallenge1	Challenge	app/sdk/challenges/songhai/AdvancedSonghaiChallenge1.coffee
BeginnerSonghaiChallenge1	Challenge	app/sdk/challenges/songhai/BeginnerSonghaiChallenge1.coffee
BeginnerSonghaiChallenge2	Challenge	app/sdk/challenges/songhai/BeginnerSonghaiChallenge2.coffee
BeginnerSonghaiChallenge3	Challenge	app/sdk/challenges/songhai/BeginnerSonghaiChallenge3.coffee
BeginnerSonghaiChallenge4	Challenge	app/sdk/challenges/songhai/BeginnerSonghaiChallenge4.coffee
BeginnerSonghaiChallenge5	Challenge	app/sdk/challenges/songhai/BeginnerSonghaiChallenge5.coffee
MediumSonghaiChallenge1	Challenge	app/sdk/challenges/songhai/MediumSonghaiChallenge1.coffee
MediumSonghaiChallenge2	Challenge	app/sdk/challenges/songhai/MediumSonghaiChallenge2.coffee
BeginnerFlyingChallenge1	Challenge	app/sdk/challenges/tutorial/BeginnerFlyingChallenge1.coffee
BeginnerRangedChallenge1	Challenge	app/sdk/challenges/tutorial/BeginnerRangedChallenge1.coffee
LessonOne	Challenge	app/sdk/challenges/tutorial/lesson1.coffee
LessonTwo	Challenge	app/sdk/challenges/tutorial/lesson2.coffee
LessonThree	Challenge	app/sdk/challenges/tutorial/lesson3.coffee
LessonFour	Challenge	app/sdk/challenges/tutorial/lesson4.coffee
AdvancedVanarChallenge1	Challenge	app/sdk/challenges/vanar/AdvancedVanarChallenge1.coffee
AdvancedVanarChallenge2	Challenge	app/sdk/challenges/vanar/AdvancedVanarChallenge2.coffee
BeginnerVanarChallenge1	Challenge	app/sdk/challenges/vanar/BeginnerVanarChallenge1.coffee
BeginnerVanarChallenge2	Challenge	app/sdk/challenges/vanar/BeginnerVanarChallenge2.coffee
BeginnerVanarChallenge3	Challenge	app/sdk/challenges/vanar/BeginnerVanarChallenge3.coffee
BeginnerVanarChallenge4	Challenge	app/sdk/challenges/vanar/BeginnerVanarChallenge4.coffee
BeginnerVanarChallenge5	Challenge	app/sdk/challenges/vanar/BeginnerVanarChallenge5.coffee
AdvancedVetruvianChallenge1	Challenge	app/sdk/challenges/vetruvian/AdvancedVetruvianChallenge1.coffee
AdvancedVetruvianChallenge2	Challenge	app/sdk/challenges/vetruvian/AdvancedVetruvianChallenge2.coffee
BeginnerVetruvianChallenge1	Challenge	app/sdk/challenges/vetruvian/BeginnerVetruvianChallenge1.coffee
BeginnerVetruvianChallenge2	Challenge	app/sdk/challenges/vetruvian/BeginnerVetruvianChallenge2.coffee
BeginnerVetruvianChallenge3	Challenge	app/sdk/challenges/vetruvian/BeginnerVetruvianChallenge3.coffee
BeginnerVetruvianChallenge4	Challenge	app/sdk/challenges/vetruvian/BeginnerVetruvianChallenge4.coffee
BeginnerVetruvianChallenge5	Challenge	app/sdk/challenges/vetruvian/BeginnerVetruvianChallenge5.coffee
MediumVetruvianChallenge1	Challenge	app/sdk/challenges/vetruvian/MediumVetruvianChallenge1.coffee
MediumVetruvianChallenge2	Challenge	app/sdk/challenges/vetruvian/MediumVetruvianChallenge2.coffee
AttackRange	Range	app/sdk/entities/attackRange.coffee
Entity	Card	app/sdk/entities/entity.coffee
MovementRange	Range	app/sdk/entities/movementRange.coffee
Tile	Entity	app/sdk/entities/tile.coffee
Unit	Entity	app/sdk/entities/unit.coffee
_GameSession	SDKObject	app/sdk/gameSession.coffee
GameSessionModifier	PlayerModifier	app/sdk/gameSessionModifiers/gameSessionModifier.coffee
GameSessionModifierFestiveSpirit	GameSessionModifier	app/sdk/gameSessionModifiers/gameSessionModifierFestiveSpirit.coffee
GameTurn	SDKObject	app/sdk/gameTurn.coffee
Modifier	SDKObject	app/sdk/modifiers/modifier.coffee
ModifierATKThresholdDie	Modifier	app/sdk/modifiers/modifierATKThresholdDie.coffee
ModifierAbsorbDamage	Modifier	app/sdk/modifiers/modifierAbsorbDamage.coffee
ModifierAbsorbDamageGolems	Modifier	app/sdk/modifiers/modifierAbsorbDamageGolems.coffee
ModifierAirdrop	Modifier	app/sdk/modifiers/modifierAirdrop.coffee
ModifierAlwaysBackstabbed	Modifier	app/sdk/modifiers/modifierAlwaysBackstabbed.coffee
ModifierAlwaysInfiltrated	Modifier	app/sdk/modifiers/modifierAlwaysInfiltrated.coffee
ModifierAntiMagicField	Modifier	app/sdk/modifiers/modifierAntiMagicField.coffee
ModifierAnyDrawCardWatch	Modifier	app/sdk/modifiers/modifierAnyDrawCardWatch.coffee
ModifierAnyDrawCardWatchBuffSelf	ModifierAnyDrawCardWatch	app/sdk/modifiers/modifierAnyDrawCardWatchBuffSelf.coffee
ModifierAnyMinionHealWatch	Modifier	app/sdk/modifiers/modifierAnyMinionHealWatch.coffee
ModifierAnySummonWatch	Modifier	app/sdk/modifiers/modifierAnySummonWatch.coffee
ModifierAnySummonWatchFromActionBar	Modifier	app/sdk/modifiers/modifierAnySummonWatchFromActionBar.coffee
ModifierAnySummonWatchFromActionBarApplyModifiersToSelf	ModifierAnySummonWatchFromActionBar	app/sdk/modifiers/modifierAnySummonWatchFromActionBarApplyModifiersToSelf.coffee
ModifierAnySummonWatchGainGeneralKeywords	ModifierAnySummonWatch	app/sdk/modifiers/modifierAnySummonWatchGainGeneralKeywords.coffee
ModifierApplyMinionToBoardWatch	Modifier	app/sdk/modifiers/modifierApplyMinionToBoardWatch.coffee
ModifierApplyMinionToBoardWatchApplyModifiersToTarget	ModifierApplyMinionToBoardWatch	app/sdk/modifiers/modifierApplyMinionToBoardWatchApplyModifiersToTarget.coffee
ModifierAttackEqualsHealth	Modifier	app/sdk/modifiers/modifierAttackEqualsHealth.coffee
ModifierAttacksDamageAllEnemyMinions	Modifier	app/sdk/modifiers/modifierAttacksDamageAllEnemyMinions.coffee
ModifierAttacksDealNoDamage	Modifier	app/sdk/modifiers/modifierAttacksDealNoDamage.coffee
ModifierAuraAboveAndBelow	Modifier	app/sdk/modifiers/modifierAuraAboveAndBelow.coffee
ModifierBackstab	Modifier	app/sdk/modifiers/modifierBackstab.coffee
ModifierBackstabWatch	Modifier	app/sdk/modifiers/modifierBackstabWatch.coffee
ModifierBackstabWatchAddCardToHand	ModifierBackstabWatch	app/sdk/modifiers/modifierBackstabWatchAddCardToHand.coffee
ModifierBackstabWatchApplyModifiersToTarget	ModifierBackstabWatch	app/sdk/modifiers/modifierBackstabWatchApplyModifiersToTarget.coffee
ModifierBackstabWatchApplyPlayerModifiers	ModifierBackstabWatch	app/sdk/modifiers/modifierBackstabWatchApplyPlayerModifiers.coffee
ModifierBackstabWatchStealSpellFromDeck	ModifierBackstabWatch	app/sdk/modifiers/modifierBackstabWatchStealSpellFromDeck.coffee
ModifierBackstabWatchSummonBackstabMinion	ModifierBackstabWatch	app/sdk/modifiers/modifierBackstabWatchSummonBackstabMinion.coffee
ModifierBackstabWatchTransformToBuilding	ModifierBackstabWatch	app/sdk/modifiers/modifierBackstabWatchTransformToBuilding.coffee
ModifierBackupGeneral	Modifier	app/sdk/modifiers/modifierBackupGeneral.coffee
ModifierBanded	Modifier	app/sdk/modifiers/modifierBanded.coffee
ModifierBandedDoubleAttack	ModifierBanded	app/sdk/modifiers/modifierBandedDoubleAttack.coffee
ModifierBandedFlying	ModifierFlying	app/sdk/modifiers/modifierBandedFlying.coffee
ModifierBandedHeal	ModifierBanded	app/sdk/modifiers/modifierBandedHeal.coffee
ModifierBandedProvoke	ModifierProvoke	app/sdk/modifiers/modifierBandedProvoke.coffee
ModifierBandedRanged	ModifierRanged	app/sdk/modifiers/modifierBandedRanged.coffee
ModifierBanding	ModifierSituationalBuffSelf	app/sdk/modifiers/modifierBanding.coffee
ModifierBandingApplyModifiers	ModifierBanding	app/sdk/modifiers/modifierBandingApplyModifiers.coffee
ModifierBandingAttack	ModifierBanding	app/sdk/modifiers/modifierBandingAttack.coffee
ModifierBandingAttackAndHealth	ModifierBanding	app/sdk/modifiers/modifierBandingAttackAndHealth.coffee
ModifierBandingChangeCardDraw	ModifierBanding	app/sdk/modifiers/modifierBandingChangeCardDraw.coffee
ModifierBandingDealDamageWatchDrawCard	ModifierBanding	app/sdk/modifiers/modifierBandingDealDamageWatchDrawCard.coffee
ModifierBandingDoubleAttack	ModifierBanding	app/sdk/modifiers/modifierBandingDoubleAttack.coffee
ModifierBandingFlying	ModifierBanding	app/sdk/modifiers/modifierBandingFlying.coffee
ModifierBandingHeal	ModifierBanding	app/sdk/modifiers/modifierBandingHeal.coffee
ModifierBandingHealSelfAndGeneral	ModifierBanding	app/sdk/modifiers/modifierBandingHealSelfAndGeneral.coffee
ModifierBandingProvoke	ModifierBanding	app/sdk/modifiers/modifierBandingProvoke.coffee
ModifierBandingRanged	ModifierBanding	app/sdk/modifiers/modifierBandingRanged.coffee
ModifierBattlePet	Modifier	app/sdk/modifiers/modifierBattlePet.coffee
ModifierBeforeMyAttackWatch	Modifier	app/sdk/modifiers/modifierBeforeMyAttackWatch.coffee
ModifierBelongsToAllRaces	Modifier	app/sdk/modifiers/modifierBelongsToAllRaces.coffee
ModifierBlastAttack	Modifier	app/sdk/modifiers/modifierBlastAttack.coffee
ModifierBlastAttackStrong	ModifierBlastAttack	app/sdk/modifiers/modifierBlastAttackStrong.coffee
ModifierBond	Modifier	app/sdk/modifiers/modifierBond.coffee
ModifierBondApplyModifiers	ModifierBond	app/sdk/modifiers/modifierBondApplyModifiers.coffee
ModifierBondApplyModifiersByRaceId	ModifierBondAplyModifiers	app/sdk/modifiers/modifierBondApplyModifiersByRaceId.coffee
ModifierBondDrawCards	ModifierBond	app/sdk/modifiers/modifierBondDrawCards.coffee
ModifierBondHealMyGeneral	ModifierBond	app/sdk/modifiers/modifierBondHealMyGeneral.coffee
ModifierBondNightshroud	ModifierBond	app/sdk/modifiers/modifierBondNightshroud.coffee
ModifierBondPutCardsInHand	ModifierBond	app/sdk/modifiers/modifierBondPutCardsInHand.coffee
ModifierBondSpawnEntity	ModifierBond	app/sdk/modifiers/modifierBondSpawnEntity.coffee
ModifierBuffSelfOnReplace	Modifier	app/sdk/modifiers/modifierBuffSelfOnReplace.coffee
ModifierBuild	Modifier	app/sdk/modifiers/modifierBuild.coffee
ModifierBuildCompleteApplyModifiersToNearbyAllies	ModifierBuilding	app/sdk/modifiers/modifierBuildCompleteApplyModifiersToNearbyAllies.coffee
ModifierBuildCompleteGainTempMana	ModifierBuilding	app/sdk/modifiers/modifierBuildCompleteGainTempMana.coffee
ModifierBuildCompleteHealGeneral	ModifierBuilding	app/sdk/modifiers/modifierBuildCompleteHealGeneral.coffee
ModifierBuildCompleteReplicateAndSummonDervish	ModifierBuilding	app/sdk/modifiers/modifierBuildCompleteReplicateAndSummonDervish.coffee
ModifierBuildWatch	Modifier	app/sdk/modifiers/modifierBuildWatch.coffee
ModifierBuilding	ModifierStartTurnWatch	app/sdk/modifiers/modifierBuilding.coffee
ModifierBuildingSlowEnemies	ModifierBuilding	app/sdk/modifiers/modifierBuildingSlowEnemies.coffee
ModifierCannot	Modifier	app/sdk/modifiers/modifierCannot.coffee
ModifierCannotAttackGeneral	ModifierCannot	app/sdk/modifiers/modifierCannotAttackGeneral.coffee
ModifierCannotBeRemovedFromHand	ModifierCannot	app/sdk/modifiers/modifierCannotBeRemovedFromHand.coffee
ModifierCannotBeReplaced	ModifierCannot	app/sdk/modifiers/modifierCannotBeReplaced.coffee
ModifierCannotCastBBS	ModifierCannot	app/sdk/modifiers/modifierCannotCastBBS.coffee
ModifierCannotCastSpellsByCost	ModifierCannot	app/sdk/modifiers/modifierCannotCastSpellsByCost.coffee
ModifierCannotDamageGenerals	ModifierCannot	app/sdk/modifiers/modifierCannotDamageGenerals.coffee
ModifierCannotMove	ModifierCannot	app/sdk/modifiers/modifierCannotMove.coffee
ModifierCannotStrikeback	ModifierCannot	app/sdk/modifiers/modifierCannotStrikeback.coffee
ModifierCardControlledPlayerModifiers	Modifier	app/sdk/modifiers/modifierCardControlledPlayerModifiers.coffee
ModifierCollectable	Modifier	app/sdk/modifiers/modifierCollectable.coffee
ModifierCollectableBonusMana	ModifierCollectable	app/sdk/modifiers/modifierCollectableBonusMana.coffee
ModifierCollectableCard	ModifierCollectable	app/sdk/modifiers/modifierCollectableCard.coffee
ModifierCostChangeIfMyGeneralDamagedLastTurn	ModifierMyGeneralDamagedWatch	app/sdk/modifiers/modifierCostChangeIfMyGeneralDamagedLastTurn.coffee
ModifierCostEqualGeneralHealth	Modifier	app/sdk/modifiers/modifierCostEqualGeneralHealth.coffee
ModifierCounter	Modifier	app/sdk/modifiers/modifierCounter.coffee
ModifierCounterBuildProgress	ModifierCounter	app/sdk/modifiers/modifierCounterBuildProgress.coffee
ModifierCounterBuildProgressDescription	Modifier	app/sdk/modifiers/modifierCounterBuildProgressDescription.coffee
ModifierCounterIntensify	ModifierCounter	app/sdk/modifiers/modifierCounterIntensify.coffee
ModifierCounterIntensifyDescription	Modifier	app/sdk/modifiers/modifierCounterIntensifyDescription.coffee
ModifierCounterMechazorBuildProgress	ModifierCounter	app/sdk/modifiers/modifierCounterMechazorBuildProgress.coffee
ModifierCounterMechazorBuildProgressDescription	Modifier	app/sdk/modifiers/modifierCounterMechazorBuildProgressDescription.coffee
ModifierCounterShadowCreep	ModifierCounter	app/sdk/modifiers/modifierCounterShadowCreep.coffee
ModifierCounterShadowCreepDescriptionProgressDescription	Modifier	app/sdk/modifiers/modifierCounterShadowCreepDescription.coffee
ModifierCustomSpawn	Modifier	app/sdk/modifiers/modifierCustomSpawn.coffee
ModifierCustomSpawnOnOtherUnit	ModifierCustomSpawn	app/sdk/modifiers/modifierCustomSpawnOnOtherUnit.coffee
ModifierDamageAreaAttack	Modifier	app/sdk/modifiers/modifierDamageAreaAttack.coffee
ModifierDamageBothGeneralsOnReplace	Modifier	app/sdk/modifiers/modifierDamageBothGeneralsOnReplace.coffee
ModifierDamageGeneralOnAttack	ModifierDealDamageWatch	app/sdk/modifiers/modifierDamageGeneralOnAttack.coffee
ModifierDealDamageWatch	Modifier	app/sdk/modifiers/modifierDealDamageWatch.coffee
ModifierDealDamageWatchApplyModifiersToAllies	ModifierDealDamageWatch	app/sdk/modifiers/modifierDealDamageWatchApplyModifiersToAllies.coffee
ModifierDealDamageWatchBuffSelf	ModifierDealDamageWatch	app/sdk/modifiers/modifierDealDamageWatchBuffSelf.coffee
ModifierDealDamageWatchControlEnemyMinionUntilEOT	ModifierDealDamageWatch	app/sdk/modifiers/modifierDealDamageWatchControlEnemyMinionUntilEOT.coffee
ModifierDealDamageWatchDamageJoinedEnemies	ModifierDealDamageWatch	app/sdk/modifiers/modifierDealDamageWatchDamageJoinedEnemies.coffee
ModifierDealDamageWatchDrawCard	ModifierDealDamageWatch	app/sdk/modifiers/modifierDealDamageWatchDrawCard.coffee
ModifierDealDamageWatchHatchEggs	ModifierDealDamageWatch	app/sdk/modifiers/modifierDealDamageWatchHatchEggs.coffee
ModifierDealDamageWatchHealMyGeneral	ModifierDealDamageWatch	app/sdk/modifiers/modifierDealDamageWatchHealMyGeneral.coffee
ModifierDealDamageWatchHealorDamageGeneral	ModifierDealDamageWatch	app/sdk/modifiers/modifierDealDamageWatchHealorDamageGeneral.coffee
ModifierDealDamageWatchIfMinionHealMyGeneral	ModifierDealDamageWatchHealMyGeneral	app/sdk/modifiers/modifierDealDamageWatchIfMinionHealMyGeneral.coffee
ModifierDealDamageWatchKillNeutralTarget	ModifierDealDamageWatchKillTarget	app/sdk/modifiers/modifierDealDamageWatchKillNeutralTarget.coffee
ModifierDealDamageWatchKillTarget	ModifierDealDamageWatch	app/sdk/modifiers/modifierDealDamageWatchKillTarget.coffee
ModifierDealDamageWatchKillTargetAndSelf	ModifierDealDamageWatch	app/sdk/modifiers/modifierDealDamageWatchKillTargetAndSelf.coffee
ModifierDealDamageWatchModifyTarget	ModifierDealDamageWatch	app/sdk/modifiers/modifierDealDamageWatchModifyTarget.coffee
ModifierDealDamageWatchRefreshSignatureCard	ModifierDealDamageWatch	app/sdk/modifiers/modifierDealDamageWatchRefreshSignatureCard.coffee
ModifierDealDamageWatchSpawnEntity	ModifierDealDamageWatch	app/sdk/modifiers/modifierDealDamageWatchSpawnEntity.coffee
ModifierDealDamageWatchTeleportEnemyToYourSide	ModifierDealDamageWatch	app/sdk/modifiers/modifierDealDamageWatchTeleportEnemyToYourSide.coffee
ModifierDealDamageWatchTeleportToMe	ModifierDealDamageWatch	app/sdk/modifiers/modifierDealDamageWatchTeleportToMe.coffee
ModifierDealOrTakeDamageWatch	Modifier	app/sdk/modifiers/modifierDealOrTakeDamageWatch.coffee
ModifierDealOrTakeDamageWatchRandomTeleportOther	ModifierDealOrTakeDamageWatch	app/sdk/modifiers/modifierDealOrTakeDamageWatchRandomTeleportOther.coffee
ModifierDeathWatch	Modifier	app/sdk/modifiers/modifierDeathWatch.coffee
ModifierDeathWatchBuffMinionsInHand	ModifierDeathWatch	app/sdk/modifiers/modifierDeathWatchBuffMinionsInHand.coffee
ModifierDeathWatchBuffRandomMinionInHand	ModifierDeathWatch	app/sdk/modifiers/modifierDeathWatchBuffRandomMinionInHand.coffee
ModifierDeathWatchBuffSelf	ModifierDeathWatch	app/sdk/modifiers/modifierDeathWatchBuffSelf.coffee
ModifierDeathWatchDamageEnemyGeneralHealMyGeneral	ModifierDeathWatch	app/sdk/modifiers/modifierDeathWatchDamageEnemyGeneralHealMyGeneral.coffee
ModifierDeathWatchDamageRandomMinionHealMyGeneral	ModifierDeathWatch	app/sdk/modifiers/modifierDeathWatchDamageRandomMinionHealMyGeneral.coffee
ModifierDeathWatchDrawToXCards	ModifierDeathWatch	app/sdk/modifiers/modifierDeathWatchDrawToXCards.coffee
ModifierDeathWatchFriendlyMinionSwapAllegiance	ModifierDeathWatch	app/sdk/modifiers/modifierDeathWatchFriendlyMinionSwapAllegiance.coffee
ModifierDeathWatchGainAttackEqualToEnemyAttack	ModifierDeathWatch	app/sdk/modifiers/modifierDeathWatchGainAttackEqualToEnemyAttack.coffee
ModifierDeathWatchSpawnEntity	ModifierDeathWatch	app/sdk/modifiers/modifierDeathWatchSpawnEntity.coffee
ModifierDeathWatchSpawnRandomDemon	ModifierDeathWatch	app/sdk/modifiers/modifierDeathWatchSpawnRandomDemon.coffee
ModifierDestroyAtEndOfTurn	Modifier	app/sdk/modifiers/modifierDestroyAtEndOfTurn.coffee
ModifierDestructible	Modifier	app/sdk/modifiers/modifierDestructible.coffee
ModifierDieSpawnNewGeneral	Modifier	app/sdk/modifiers/modifierDieSpawnNewGeneral.coffee
ModifierDispelAreaAttack	Modifier	app/sdk/modifiers/modifierDispelAreaAttack.coffee
ModifierDispelOnAttack	Modifier	app/sdk/modifiers/modifierDispelOnAttack.coffee
ModifierDoomed	ModifierEndTurnWatch	app/sdk/modifiers/modifierDoomed.coffee
ModifierDoomed2	ModifierEndTurnWatch	app/sdk/modifiers/modifierDoomed2.coffee
ModifierDoomed3	ModifierEndTurnWatch	app/sdk/modifiers/modifierDoomed3.coffee
ModifierDoubleAttackStat	Modifier	app/sdk/modifiers/modifierDoubleAttackStat.coffee
ModifierDoubleDamageToEnemyMinions	Modifier	app/sdk/modifiers/modifierDoubleDamageToEnemyMinions.coffee
ModifierDoubleDamageToGenerals	Modifier	app/sdk/modifiers/modifierDoubleDamageToGenerals.coffee
ModifierDoubleDamageToMinions	Modifier	app/sdk/modifiers/modifierDoubleDamageToMinions.coffee
ModifierDoubleDamageToStunnedEnemies	Modifier	app/sdk/modifiers/modifierDoubleDamageToStunnedEnemies.coffee
ModifierDoubleHealthStat	Modifier	app/sdk/modifiers/modifierDoubleHealthStat.coffee
ModifierDrawCardWatch	Modifier	app/sdk/modifiers/modifierDrawCardWatch.coffee
ModifierDrawCardWatchBuffSelf	ModifierDrawCardWatch	app/sdk/modifiers/modifierDrawCardWatchBuffSelf.coffee
ModifierDrawCardWatchCopySpell	ModifierDrawCardWatch	app/sdk/modifiers/modifierDrawCardWatchCopySpell.coffee
ModifierDyingWish	Modifier	app/sdk/modifiers/modifierDyingWish.coffee
ModifierDyingWishAddCardToDeck	ModifierDyingWish	app/sdk/modifiers/modifierDyingWishAddCardToDeck.coffee
ModifierDyingWishApplyModifiers	ModifierDyingWish	app/sdk/modifiers/modifierDyingWishApplyModifiers.coffee
ModifierDyingWishApplyModifiersRandomly	ModifierDyingWishApplyModifiers	app/sdk/modifiers/modifierDyingWishApplyModifiersRandomly.coffee
ModifierDyingWishApplyModifiersToGenerals	ModifierDyingWish	app/sdk/modifiers/modifierDyingWishApplyModifiersToGenerals.coffee
ModifierDyingWishBonusMana	ModifierDyingWish	app/sdk/modifiers/modifierDyingWishBonusMana.coffee
ModifierDyingWishBonusManaCrystal	ModifierDyingWish	app/sdk/modifiers/modifierDyingWishBonusManaCrystal.coffee
ModifierDyingWishBuffEnemyGeneral	ModifierDyingWish	app/sdk/modifiers/modifierDyingWishBuffEnemyGeneral.coffee
ModifierDyingWishCorpseCombustion	ModifierDyingWish	app/sdk/modifiers/modifierDyingWishCorpseCombustion.coffee
ModifierDyingWishDagona	ModifierDyingWishSpawnEntity	app/sdk/modifiers/modifierDyingWishDagona.coffee
ModifierDyingWishDamageEnemyGeneralHealGeneral	ModifierDyingWish	app/sdk/modifiers/modifierDyingWishDamageEnemyGeneralHealGeneral.coffee
ModifierDyingWishDamageGeneral	ModifierDyingWish	app/sdk/modifiers/modifierDyingWishDamageGeneral.coffee
ModifierDyingWishDamageNearbyAllies	ModifierDyingWish	app/sdk/modifiers/modifierDyingWishDamageNearbyAllies.coffee
ModifierDyingWishDamageNearbyEnemies	ModifierDyingWish	app/sdk/modifiers/modifierDyingWishDamageNearbyEnemies.coffee
ModifierDyingWishDestroyManaCrystal	ModifierDyingWish	app/sdk/modifiers/modifierDyingWishDestroyManaCrystal.coffee
ModifierDyingWishDestroyRandomEnemyNearby	ModifierDyingWish	app/sdk/modifiers/modifierDyingWishDestroyRandomEnemyNearby.coffee
ModifierDyingWishDispelAllEnemyMinions	ModifierDyingWish	app/sdk/modifiers/modifierDyingWishDispelAllEnemyMinions.coffee
ModifierDyingWishDispelNearestEnemy	ModifierDyingWish	app/sdk/modifiers/modifierDyingWishDispelNearestEnemy.coffee
ModifierDyingWishDrawCard	ModifierDyingWish	app/sdk/modifiers/modifierDyingWishDrawCard.coffee
ModifierDyingWishDrawEnemyLegendaryArtifact	ModifierDyingWish	app/sdk/modifiers/modifierDyingWishDrawEnemyLegendaryArtifact.coffee
ModifierDyingWishDrawMechazorCard	ModifierDyingWish	app/sdk/modifiers/modifierDyingWishDrawMechazorCard.coffee
ModifierDyingWishDrawMinionsWithDyingWish	ModifierDyingWish	app/sdk/modifiers/modifierDyingWishDrawMinionsWithDyingWish.coffee
ModifierDyingWishDrawRandomBattlePet	ModifierDyingWish	app/sdk/modifiers/modifierDyingWishDrawRandomBattlePet.coffee
ModifierDyingWishDrawWishCard	ModifierDyingWish	app/sdk/modifiers/modifierDyingWishDrawWishCard.coffee
ModifierDyingWishEquipArtifactFromDeck	ModifierDyingWish	app/sdk/modifiers/modifierDyingWishEquipArtifactFromDeck.coffee
ModifierDyingWishGoldenGuide	ModifierDyingWish	app/sdk/modifiers/modifierDyingWishGoldenGuide.coffee
ModifierDyingWishInfest	ModifierDyingWish	app/sdk/modifiers/modifierDyingWishInfest.coffee
ModifierDyingWishLoseGame	ModifierDyingWish	app/sdk/modifiers/modifierDyingWishLoseGame.coffee
ModifierDyingWishPutCardInHand	ModifierDyingWish	app/sdk/modifiers/modifierDyingWishPutCardInHand.coffee
ModifierDyingWishPutCardInHandClean	ModifierDyingWishPutCardInHand	app/sdk/modifiers/modifierDyingWishPutCardInHandClean.coffee
ModifierDyingWishPutCardInOpponentHand	ModifierDyingWish	app/sdk/modifiers/modifierDyingWishPutCardInOpponentHand.coffee
ModifierDyingWishReSpawnEntityAnywhere	ModifierDyingWish	app/sdk/modifiers/modifierDyingWishReSpawnEntityAnywhere.coffee
ModifierDyingWishReduceManaCostOfDyingWish	ModifierDyingWish	app/sdk/modifiers/modifierDyingWishReduceManaCostOfDyingWish.coffee
ModifierDyingWishRespawnEntity	ModifierDyingWish	app/sdk/modifiers/modifierDyingWishRespawnEntity.coffee
ModifierDyingWishSpawnEgg	ModifierDyingWishSpawnEntity	app/sdk/modifiers/modifierDyingWishSpawnEgg.coffee
ModifierDyingWishSpawnEntity	ModifierDyingWish	app/sdk/modifiers/modifierDyingWishSpawnEntity.coffee
ModifierDyingWishSpawnEntityAnywhere	ModifierDyingWish	app/sdk/modifiers/modifierDyingWishSpawnEntityAnywhere.coffee
ModifierDyingWishSpawnEntityInCorner	ModifierDyingWish	app/sdk/modifiers/modifierDyingWishSpawnEntityInCorner.coffee
ModifierDyingWishSpawnEntityNearbyGeneral	ModifierDyingWish	app/sdk/modifiers/modifierDyingWishSpawnEntityNearbyGeneral.coffee
ModifierDyingWishSpawnRandomEntity	ModifierDyingWishSpawnEntity	app/sdk/modifiers/modifierDyingWishSpawnRandomEntity.coffee
ModifierDyingWishSpawnTile	ModifierDyingWishSpawnEntity	app/sdk/modifiers/modifierDyingWishSpawnTile.coffee
ModifierDyingWishSpawnTileAnywhere	ModifierDyingWishSpawnEntityAnywhere	app/sdk/modifiers/modifierDyingWishSpawnTileAnywhere.coffee
ModifierDyingWishSpawnTribal	ModifierDyingWish	app/sdk/modifiers/modifierDyingWishSpawnTribal.coffee
ModifierDyingWishSpawnUnitFromOpponentsDeck	ModifierDyingWish	app/sdk/modifiers/modifierDyingWishSpawnUnitFromOpponentsDeck.coffee
ModifierDyingWishTransformRandomMinion	ModifierDyingWish	app/sdk/modifiers/modifierDyingWishTransformRandomMinion.coffee
ModifierDyingWishXho	ModifierDyingWish	app/sdk/modifiers/modifierDyingWishXho.coffee
ModifierDynamicCountModifySelf	Modifier	app/sdk/modifiers/modifierDynamicCountModifySelf.coffee
ModifierDynamicCountModifySelfByShadowTilesOnBoard	ModifierDynamicCountModifySelf	app/sdk/modifiers/modifierDynamicCountModifySelfByShadowTilesOnBoard.coffee
ModifierDynamicCountModifySelfCostByBattlePetsOnBoard	ModifierDynamicCountModifySelf	app/sdk/modifiers/modifierDynamicCountModifySelfCostByBattlePetsOnBoard.coffee
ModifierEgg	ModifierRemoveAndReplaceEntity	app/sdk/modifiers/modifierEgg.coffee
ModifierElkowl	ModifierOpeningGambit	app/sdk/modifiers/modifierElkowl.coffee
ModifierEndEveryTurnWatch	Modifier	app/sdk/modifiers/modifierEndEveryTurnWatch.coffee
ModifierEndEveryTurnWatchDamageOwner	ModifierEndEveryTurnWatch	app/sdk/modifiers/modifierEndEveryTurnWatchDamageOwner.coffee
ModifierEndTurnWatch	Modifier	app/sdk/modifiers/modifierEndTurnWatch.coffee
ModifierEndTurnWatchAnyPlayer	Modifier	app/sdk/modifiers/modifierEndTurnWatchAnyPlayer.coffee
ModifierEndTurnWatchAnyPlayerHsuku	ModifierEndTurnWatchAnyPlayer	app/sdk/modifiers/modifierEndTurnWatchAnyPlayerHsuku.coffee
ModifierEndTurnWatchAnyPlayerPullRandomUnits	ModifierEndTurnWatchAnyPlayer	app/sdk/modifiers/modifierEndTurnWatchAnyPlayerPullRandomUnits.coffee
ModifierEndTurnWatchApplyModifiers	ModifierEndTurnWatch	app/sdk/modifiers/modifierEndTurnWatchApplyModifiers.coffee
ModifierEndTurnWatchApplyModifiersRandomly	ModifierEndTurnWatchApplyModifiers	app/sdk/modifiers/modifierEndTurnWatchApplyModifiersRandomly.coffee
ModifierEndTurnWatchDamageAllMinions	ModifierEndTurnWatch	app/sdk/modifiers/modifierEndTurnWatchDamageAllMinions.coffee
ModifierEndTurnWatchDamageNearbyEnemy	ModifierEndTurnWatch	app/sdk/modifiers/modifierEndTurnWatchDamageNearbyEnemy.coffee
ModifierEndTurnWatchDamagePlayerBasedOnRemainingMana	ModifierEndEveryTurnWatch	app/sdk/modifiers/modifierEndTurnWatchDamagePlayerBasedOnRemainingMana.coffee
ModifierEndTurnWatchDealDamageToSelfAndNearbyEnemies	ModifierEndTurnWatch	app/sdk/modifiers/modifierEndTurnWatchDealDamageToSelfAndNearbyEnemies.coffee
ModifierEndTurnWatchGainLastSpellPlayedThisTurn	ModifierEndTurnWatch	app/sdk/modifiers/modifierEndTurnWatchGainLastSpellPlayedThisTurn.coffee
ModifierEndTurnWatchGainTempBuff	ModifierEndTurnWatch	app/sdk/modifiers/modifierEndTurnWatchGainTempBuff.coffee
ModifierEndTurnWatchHealNearby	ModifierEndTurnWatch	app/sdk/modifiers/modifierEndTurnWatchHealNearby.coffee
ModifierEndTurnWatchHealSelf	ModifierEndTurnWatch	app/sdk/modifiers/modifierEndTurnWatchHealSelf.coffee
ModifierEndTurnWatchHealSelfAndGeneral	ModifierEndTurnWatch	app/sdk/modifiers/modifierEndTurnWatchHealSelfAndGeneral.coffee
ModifierEndTurnWatchHsuku	ModifierEndTurnWatch	app/sdk/modifiers/modifierEndTurnWatchHsuku.coffee
ModifierEndTurnWatchRefreshArtifacts	ModifierEndTurnWatch	app/sdk/modifiers/modifierEndTurnWatchRefreshArtifacts.coffee
ModifierEndTurnWatchSpawnEgg	ModifierEndTurnWatchSpawnEntity	app/sdk/modifiers/modifierEndTurnWatchSpawnEgg.coffee
ModifierEndTurnWatchSpawnEntity	ModifierEndTurnWatch	app/sdk/modifiers/modifierEndTurnWatchSpawnEntity.coffee
ModifierEndTurnWatchSpawnRandomEntity	ModifierEndTurnWatchSpawnEntity	app/sdk/modifiers/modifierEndTurnWatchSpawnRandomEntity.coffee
ModifierEndTurnWatchSpawnTile	ModifierEndTurnWatchSpawnEntity	app/sdk/modifiers/modifierEndTurnWatchSpawnTile.coffee
ModifierEndTurnWatchSwapAllegiance	ModifierEndTurnWatch	app/sdk/modifiers/modifierEndTurnWatchSwapAllegiance.coffee
ModifierEndTurnWatchTeleportCorner	ModifierEndTurnWatch	app/sdk/modifiers/modifierEndTurnWatchTeleportCorner.coffee
ModifierEndTurnWatchTransformNearbyEnemies	ModifierEndTurnWatch	app/sdk/modifiers/modifierEndTurnWatchTransformNearbyEnemies.coffee
ModifierEnemyAttackWatch	Modifier	app/sdk/modifiers/modifierEnemyAttackWatch.coffee
ModifierEnemyAttackWatchGainAttack	ModifierEnemyAttackWatch	app/sdk/modifiers/modifierEnemyAttackWatchGainAttack.coffee
ModifierEnemyCannotCastBBS	ModifierCannot	app/sdk/modifiers/modifierEnemyCannotCastBBS.coffee
ModifierEnemyCannotHeal	Modifier	app/sdk/modifiers/modifierEnemyCannotHeal.coffee
ModifierEnemyDealDamageWatch	Modifier	app/sdk/modifiers/modifierEnemyDealDamageWatch.coffee
ModifierEnemyGeneralAttackWatch	Modifier	app/sdk/modifiers/modifierEnemyGeneralAttackWatch.coffee
ModifierEnemyGeneralAttackedWatch	Modifier	app/sdk/modifiers/modifierEnemyGeneralAttackedWatch.coffee
ModifierEnemyGeneralAttackedWatchSummonBehindAndDrawCard	ModifierEnemyGeneralAttackedWatch	app/sdk/modifiers/modifierEnemyGeneralAttackedWatchSummonBehindAndDrawCard.coffee
ModifierEnemyMinionAttackWatch	Modifier	app/sdk/modifiers/modifierEnemyMinionAttackWatch.coffee
ModifierEnemyMinionAttackWatchGainKeyword	ModifierEnemyMinionAttackWatch	app/sdk/modifiers/modifierEnemyMinionAttackWatchGainKeyword.coffee
ModifierEnemySpellWatch	Modifier	app/sdk/modifiers/modifierEnemySpellWatch.coffee
ModifierEnemySpellWatchBuffSelf	ModifierEnemySpellWatch	app/sdk/modifiers/modifierEnemySpellWatchBuffSelf.coffee
ModifierEnemySpellWatchCopySpell	ModifierEnemySpellWatch	app/sdk/modifiers/modifierEnemySpellWatchCopySpell.coffee
ModifierEnemySpellWatchFromHand	Modifier	app/sdk/modifiers/modifierEnemySpellWatchFromHand.coffee
ModifierSpellWatchGainRandomKeyword	ModifierEnemySpellWatch	app/sdk/modifiers/modifierEnemySpellWatchGainRandomKeyword.coffee
ModifierEnemySpellWatchHealMyGeneral	ModifierEnemySpellWatch	app/sdk/modifiers/modifierEnemySpellWatchHealMyGeneral.coffee
ModifierEnemySpellWatchPutCardInHand	ModifierEnemySpellWatch	app/sdk/modifiers/modifierEnemySpellWatchPutCardInHand.coffee
ModifierEnemyStunWatch	Modifier	app/sdk/modifiers/modifierEnemyStunWatch.coffee
ModifierEnemyStunWatchDamageNearbyEnemies	ModifierEnemyStunWatch	app/sdk/modifiers/modifierEnemyStunWatchDamageNearbyEnemies.coffee
ModifierEnemyStunWatchFullyHeal	ModifierEnemyStunWatch	app/sdk/modifiers/modifierEnemyStunWatchFullyHeal.coffee
ModifierEnemyStunWatchTransformThis	ModifierEnemyStunWatch	app/sdk/modifiers/modifierEnemyStunWatchTransformThis.coffee
ModifierEnemyTakeDamageWatch	Modifier	app/sdk/modifiers/modifierEnemyTakeDamageWatch.coffee
ModifierEnemyTakeDamageWatchHealMyGeneral	ModifierEnemyTakeDamageWatch	app/sdk/modifiers/modifierEnemyTakeDamageWatchHealMyGeneral.coffee
ModifierEnemyTeamMoveWatch	Modifier	app/sdk/modifiers/modifierEnemyTeamMoveWatch.coffee
ModifierEnemyTeamMoveWatchSummonEntityBehind	ModifierEnemyTeamMoveWatch	app/sdk/modifiers/modifierEnemyTeamMoveWatchSummonEntityBehind.coffee
ModifierEntersBattlefieldWatch	Modifier	app/sdk/modifiers/modifierEntersBattlefieldWatch.coffee
ModifierEntersBattlefieldWatchApplyModifiers	ModifierEntersBattlefieldWatch	app/sdk/modifiers/modifierEntersBattlefieldWatchApplyModifiers.coffee
ModifierEnvyBaer	ModifierDealDamageWatch	app/sdk/modifiers/modifierEnvyBaer.coffee
ModifierEphemeral	ModifierEndTurnWatch	app/sdk/modifiers/modifierEphemeral.coffee
ModifierEquipFriendlyArtifactWatch	Modifier	app/sdk/modifiers/modifierEquipFriendlyArtifactWatch.coffee
ModifierEquipFriendlyArtifactWatchGainAttackEqualToCost	ModifierEquipFriendlyArtifactWatch	app/sdk/modifiers/modifierEquipFriendlyArtifactWatchGainAttackEqualToCost.coffee
ModifierEternalHeart	Modifier	app/sdk/modifiers/modifierEternalHeart.coffee
ModifierExpireApplyModifiers	Modifier	app/sdk/modifiers/modifierExpireApplyModifiers.coffee
ModifierExtraDamageOnCounterattack	Modifier	app/sdk/modifiers/modifierExtraDamageOnCounterattack.coffee
ModifierFate	Modifier	app/sdk/modifiers/modifierFate.coffee
ModifierFateAbyssianDyingQuest	ModifierFate	app/sdk/modifiers/modifierFateAbyssianDyingQuest.coffee
ModifierFateLyonarSmallMinionQuest	ModifierFate	app/sdk/modifiers/modifierFateLyonarSmallMinionQuest.coffee
ModifierFateMagmarBuffQuest	ModifierFate	app/sdk/modifiers/modifierFateMagmarBuffQuest.coffee
ModifierFateSingleton	ModifierFate	app/sdk/modifiers/modifierFateSingleton.coffee
ModifierFateSonghaiMinionQuest	ModifierFate	app/sdk/modifiers/modifierFateSonghaiMinionQuest.coffee
ModifierFateVanarTokenQuest	ModifierFate	app/sdk/modifiers/modifierFateVanarTokenQuest.coffee
ModifierFateVetruvianMovementQuest	ModifierFate	app/sdk/modifiers/modifierFateVetruvianMovementQuest.coffee
ModifierFeralu	Modifier	app/sdk/modifiers/modifierFeralu.coffee
ModifierFirstBlood	Modifier	app/sdk/modifiers/modifierFirstBlood.coffee
ModifierFlying	Modifier	app/sdk/modifiers/modifierFlying.coffee
ModifierForcefield	Modifier	app/sdk/modifiers/modifierForcefield.coffee
ModifierForcefieldAbsorb	ModifierImmuneToDamage	app/sdk/modifiers/modifierForcefieldAbsorb.coffee
ModifierForgedArtifactDescription	Modifier	app/sdk/modifiers/modifierForgedArtifactDescription.coffee
ModifierFrenzy	Modifier	app/sdk/modifiers/modifierFrenzy.coffee
ModifierFriendlyDeathWatch	Modifier	app/sdk/modifiers/modifierFriendlyDeathWatch.coffee
ModifierFriendlyDeathWatchForBattlePetDrawCard	ModifierFriendlyDeathWatch	app/sdk/modifiers/modifierFriendlyDeathWatchForBattlePetDrawCard.coffee
ModifierFriendsguard	ModifierFriendlyDeathWatch	app/sdk/modifiers/modifierFriendsguard.coffee
ModifierGainAttackWatch	Modifier	app/sdk/modifiers/modifierGainAttackWatch.coffee
ModifierGainAttackWatchBuffSelfBySameThisTurn	ModifierGainAttackWatch	app/sdk/modifiers/modifierGainAttackWatchBuffSelfBySameThisTurn.coffee
ModifierGrow	ModifierStartTurnWatchBuffSelf	app/sdk/modifiers/modifierGrow.coffee
ModifierGrowOnBothTurns	Modifier	app/sdk/modifiers/modifierGrowOnBothTurns.coffee
ModifierGrowPermanent	ModifierGrow	app/sdk/modifiers/modifierGrowPermanent.coffee
ModifierHPChange	Modifier	app/sdk/modifiers/modifierHPChange.coffee
ModifierHPChangeSummonEntity	ModifierHPChange	app/sdk/modifiers/modifierHPChangeSummonEntity.coffee
ModifierHPThresholdGainModifiers	ModifierHPChange	app/sdk/modifiers/modifierHPThresholdGainModifiers.coffee
ModifierHallowedGround	ModifierEndTurnWatch	app/sdk/modifiers/modifierHallowedGround.coffee
ModifierHallowedGroundBuff	Modifier	app/sdk/modifiers/modifierHallowedGroundBuff.coffee
ModifierHasBackstab	ModifierBackstab	app/sdk/modifiers/modifierHasBackstab.coffee
ModifierHealSelfWhenDealingDamage	Modifier	app/sdk/modifiers/modifierHealSelfWhenDealingDamage.coffee
ModifierHealWatch	Modifier	app/sdk/modifiers/modifierHealWatch.coffee
ModifierHealWatchBuffGeneral	ModifierHealWatch	app/sdk/modifiers/modifierHealWatchBuffGeneral.coffee
ModifierHealWatchBuffSelf	ModifierHealWatch	app/sdk/modifiers/modifierHealWatchBuffSelf.coffee
ModifierHealWatchDamageNearbyEnemies	ModifierHealWatch	app/sdk/modifiers/modifierHealWatchDamageNearbyEnemies.coffee
ModifierHealWatchDamageRandomEnemy	ModifierHealWatch	app/sdk/modifiers/modifierHealWatchDamageRandomEnemy.coffee
ModifierHealWatchPutCardInHand	ModifierHealWatch	app/sdk/modifiers/modifierHealWatchPutCardInHand.coffee
ModifierImmune	Modifier	app/sdk/modifiers/modifierImmune.coffee
ModifierImmuneToAttacks	ModifierImmune	app/sdk/modifiers/modifierImmuneToAttacks.coffee
ModifierImmuneToAttacksByGeneral	ModifierImmuneToAttacks	app/sdk/modifiers/modifierImmuneToAttacksByGeneral.coffee
ModifierImmuneToAttacksByMinions	ModifierImmuneToAttacks	app/sdk/modifiers/modifierImmuneToAttacksByMinions.coffee
ModifierImmuneToAttacksByRanged	ModifierImmuneToAttacks	app/sdk/modifiers/modifierImmuneToAttacksByRanged.coffee
ModifierImmuneToDamage	ModifierImmune	app/sdk/modifiers/modifierImmuneToDamage.coffee
ModifierImmuneToDamageByGeneral	ModifierImmuneToDamage	app/sdk/modifiers/modifierImmuneToDamageByGeneral.coffee
ModifierImmuneToDamageByRanged	ModifierImmuneToDamage	app/sdk/modifiers/modifierImmuneToDamageByRanged.coffee
ModifierImmuneToDamageBySpells	ModifierImmuneToDamage	app/sdk/modifiers/modifierImmuneToDamageBySpells.coffee
ModifierImmuneToDamageByWeakerEnemies	ModifierImmuneToDamage	app/sdk/modifiers/modifierImmuneToDamageByWeakerEnemies.coffee
ModifierImmuneToDamageFromEnemyMinions	ModifierImmuneToDamage	app/sdk/modifiers/modifierImmuneToDamageFromEnemyMinions.coffee
ModifierImmuneToDamageFromMinionsAndGenerals	ModifierImmuneToDamage	app/sdk/modifiers/modifierImmuneToDamageFromMinionsAndGenerals.coffee
ModifierImmuneToDamageOnEnemyTurn	ModifierImmuneToDamage	app/sdk/modifiers/modifierImmuneToDamageOnEnemyTurn.coffee
ModifierImmuneToSpellDamage	ModifierImmuneToDamage	app/sdk/modifiers/modifierImmuneToSpellDamage.coffee
ModifierImmuneToSpells	ModifierImmune	app/sdk/modifiers/modifierImmuneToSpells.coffee
ModifierImmuneToSpellsByEnemy	ModifierImmuneToSpells	app/sdk/modifiers/modifierImmuneToSpellsByEnemy.coffee
ModifierInfiltrate	ModifierSituationalBuffSelf	app/sdk/modifiers/modifierInfiltrate.coffee
ModifierInkhornGaze	ModifierDyingWish	app/sdk/modifiers/modifierInkhornGaze.coffee
ModifierInquisitorKron	ModifierReplaceWatchSpawnEntity	app/sdk/modifiers/modifierInquisitorKron.coffee
ModifierIntensify	Modifier	app/sdk/modifiers/modifierIntensify.coffee
ModifierIntensifyBuffSelf	ModifierIntensify	app/sdk/modifiers/modifierIntensifyBuffSelf.coffee
ModifierIntensifyDamageEnemyGeneral	ModifierIntensify	app/sdk/modifiers/modifierIntensifyDamageEnemyGeneral.coffee
ModifierIntensifyDamageNearby	ModifierIntensify	app/sdk/modifiers/modifierIntensifyDamageNearby.coffee
ModifierIntensifyOneManArmy	ModifierIntensify	app/sdk/modifiers/modifierIntensifyOneManArmy.coffee
ModifierIntensifySpawnEntitiesNearby	ModifierIntensify	app/sdk/modifiers/modifierIntensifySpawnEntitiesNearby.coffee
ModifierIntensifyTempBuffNearbyMinion	ModifierIntensify	app/sdk/modifiers/modifierIntensifyTempBuffNearbyMinion.coffee
ModifierInvalidateRush	Modifier	app/sdk/modifiers/modifierInvalidateRush.coffee
ModifierInvulnerable	ModifierUntargetable	app/sdk/modifiers/modifierInvulnerable.coffee
ModifierKillWatch	Modifier	app/sdk/modifiers/modifierKillWatch.coffee
ModifierKillWatchAndSurvive	Modifier	app/sdk/modifiers/modifierKillWatchAndSurvive.coffee
ModifierKillWatchAndSurviveScarzig	ModifierKillWatchAndSurvive	app/sdk/modifiers/modifierKillWatchAndSurviveScarzig.coffee
ModifierKillWatchBounceEnemyToActionBar	ModifierKillWatch	app/sdk/modifiers/modifierKillWatchBounceEnemyToActionBar.coffee
ModifierKillWatchDeceptibot	ModifierKillWatch	app/sdk/modifiers/modifierKillWatchDeceptibot.coffee
ModifierKillWatchHealSelf	ModifierKillWatch	app/sdk/modifiers/modifierKillWatchHealSelf.coffee
ModifierKillWatchRefreshExhaustion	ModifierKillWatch	app/sdk/modifiers/modifierKillWatchRefreshExhaustion.coffee
ModifierKillWatchRefreshExhaustionIfTargetStunned	ModifierKillWatchRefreshExhaustion	app/sdk/modifiers/modifierKillWatchRefreshExhaustionIfTargetStunned.coffee
ModifierKillWatchRespawnEntity	ModifierKillWatch	app/sdk/modifiers/modifierKillWatchRespawnEntity.coffee
ModifierKillWatchSpawnCopyNearby	ModifierKillWatch	app/sdk/modifiers/modifierKillWatchSpawnCopyNearby.coffee
ModifierKillWatchSpawnEgg	ModifierKillWatch	app/sdk/modifiers/modifierKillWatchSpawnEgg.coffee
ModifierKillWatchSpawnEnemyEntity	ModifierKillWatchSpawnEntity	app/sdk/modifiers/modifierKillWatchSpawnEnemyEntity.coffee
ModifierKillWatchSpawnEntity	ModifierKillWatch	app/sdk/modifiers/modifierKillWatchSpawnEntity.coffee
ModifierManaCostChange	Modifier	app/sdk/modifiers/modifierManaCostChange.coffee
ModifierMechazorWatchPutMechazorInHand	Modifier	app/sdk/modifiers/modifierMechazorWatchPutMechazorInHand.coffee
ModifierMirage	Modifier	app/sdk/modifiers/modifierMirage.coffee
ModifierMyAttackMinionWatch	Modifier	app/sdk/modifiers/modifierMyAttackMinionWatch.coffee
ModifierMyAttackMinionWatchKillTargetSummonThisOnSpace	ModifierMyAttackMinionWatch	app/sdk/modifiers/modifierMyAttackMinionWatchKillTargetSummonThisOnSpace.coffee
ModifierMyAttackMinionWatchStealGeneralHealth	ModifierMyAttackMinionWatch	app/sdk/modifiers/modifierMyAttackMinionWatchStealGeneralHealth.coffee
ModifierMyAttackOrAttackedWatch	Modifier	app/sdk/modifiers/modifierMyAttackOrAttackedWatch.coffee
ModifierMyAttackOrAttackedWatchDrawCard	ModifierMyAttackOrAttackedWatch	app/sdk/modifiers/modifierMyAttackOrAttackedWatchDrawCard.coffee
ModifierMyAttackOrAttackedWatchSpawnMinionNearby	ModifierMyAttackOrAttackedWatch	app/sdk/modifiers/modifierMyAttackOrAttackedWatchSpawnMinionNearby.coffee
ModifierMyAttackOrCounterattackWatch	Modifier	app/sdk/modifiers/modifierMyAttackOrCounterattackWatch.coffee
ModifierMyAttackOrCounterattackWatchApplyModifiersToFriendlyMinions	ModifierMyAttackOrCounterattackWatch	app/sdk/modifiers/modifierMyAttackOrCounterattackWatchApplyModifiersToFriendlyMinions.coffee
ModifierMyAttackOrCounterattackWatchDamageRandomEnemy	ModifierMyAttackOrCounterattackWatch	app/sdk/modifiers/modifierMyAttackOrCounterattackWatchDamageRandomEnemy.coffee
ModifierMyAttackOrCounterattackWatchTransformIntoEgg	ModifierMyAttackOrCounterattackWatch	app/sdk/modifiers/modifierMyAttackOrCounterattackWatchTransformIntoEgg.coffee
ModifierMyAttackWatch	Modifier	app/sdk/modifiers/modifierMyAttackWatch.coffee
ModifierMyAttackWatchApplyModifiers	ModifierMyAttackWatch	app/sdk/modifiers/modifierMyAttackWatchApplyModifiers.coffee
ModifierMyAttackWatchApplyModifiersToAllies	ModifierMyAttackWatch	app/sdk/modifiers/modifierMyAttackWatchApplyModifiersToAllies.coffee
ModifierMyAttackWatchAreaAttack	ModifierMyAttackWatch	app/sdk/modifiers/modifierMyAttackWatchAreaAttack.coffee
ModifierMyAttackWatchBonusManaCrystal	ModifierMyAttackWatch	app/sdk/modifiers/modifierMyAttackWatchBonusManaCrystal.coffee
ModifierMyAttackWatchBuffSelf	ModifierMyAttackWatch	app/sdk/modifiers/modifierMyAttackWatchBuffSelf.coffee
ModifierMyAttackWatchGamble	ModifierMyAttackWatch	app/sdk/modifiers/modifierMyAttackWatchGamble.coffee
ModifierMyAttackWatchGetSonghaiSpells	ModifierMyAttackWatch	app/sdk/modifiers/modifierMyAttackWatchGetSonghaiSpells.coffee
ModifierMyAttackWatchScarabBlast	ModifierMyAttackWatch	app/sdk/modifiers/modifierMyAttackWatchScarabBlast.coffee
ModifierMyAttackWatchSpawnMinionNearby	ModifierMyAttackWatch	app/sdk/modifiers/modifierMyAttackWatchSpawnMinionNearby.coffee
ModifierMyAttackWatchSummonDeadMinions	ModifierMyAttackWatch	app/sdk/modifiers/modifierMyAttackWatchSummonDeadMinions.coffee
ModifierMyBuildWatch	ModifierBuildWatch	app/sdk/modifiers/modifierMyBuildWatch.coffee
ModifierMyBuildWatchDrawCards	ModifierMyBuildWatch	app/sdk/modifiers/modifierMyBuildWatchDrawCards.coffee
ModifierMyGeneralAttackWatch	Modifier	app/sdk/modifiers/modifierMyGeneralAttackWatch.coffee
ModifierMyGeneralAttackWatchSpawnEntity	ModifierMyGeneralAttackWatch	app/sdk/modifiers/modifierMyGeneralAttackWatchSpawnEntity.coffee
ModifierMyGeneralAttackWatchSpawnRandomEntityFromDeck	ModifierMyGeneralAttackWatch	app/sdk/modifiers/modifierMyGeneralAttackWatchSpawnRandomEntityFromDeck.coffee
ModifierMyGeneralDamagedWatch	Modifier	app/sdk/modifiers/modifierMyGeneralDamagedWatch.coffee
ModifierMyGeneralDamagedWatchBuffSelf	ModifierMyGeneralDamagedWatch	app/sdk/modifiers/modifierMyGeneralDamagedWatchBuffSelf.coffee
ModifierMyGeneralDamagedWatchBuffSelfAndDrawACard	ModifierMyGeneralDamagedWatch	app/sdk/modifiers/modifierMyGeneralDamagedWatchBuffSelfAndDrawACard.coffee
ModifierMyGeneralDamagedWatchBuffSelfAttackForSame	ModifierMyGeneralDamagedWatch	app/sdk/modifiers/modifierMyGeneralDamagedWatchBuffSelfAttackForSame.coffee
ModifierMyGeneralDamagedWatchDamageNearby	ModifierMyGeneralDamagedWatch	app/sdk/modifiers/modifierMyGeneralDamagedWatchDamageNearby.coffee
ModifierMyGeneralDamagedWatchHealSelf	ModifierMyGeneralDamagedWatch	app/sdk/modifiers/modifierMyGeneralDamagedWatchHealSelf.coffee
ModifierMyGeneralDamagedWatchMiniMinion	ModifierMyGeneralDamagedWatch	app/sdk/modifiers/modifierMyGeneralDamagedWatchMiniMinion.coffee
ModifierMyHealWatchAnywhere	Modifier	app/sdk/modifiers/modifierMyHealWatchAnywhere.coffee
ModifierMyHealWatchAnywhereBuffSelf	ModifierMyHealWatchAnywhere	app/sdk/modifiers/modifierMyHealWatchAnywhereBuffSelf.coffee
ModifierMyMinionAttackWatch	Modifier	app/sdk/modifiers/modifierMyMinionAttackWatch.coffee
ModifierMyMinionAttackWatchHealGeneral	ModifierMyMinionAttackWatch	app/sdk/modifiers/modifierMyMinionAttackWatchHealGeneral.coffee
ModifierMyMinionOrGeneralDamagedWatch	Modifier	app/sdk/modifiers/modifierMyMinionOrGeneralDamagedWatch.coffee
ModifierMyMinionOrGeneralDamagedWatchBuffSelf	ModifierMyMinionOrGeneralDamagedWatch	app/sdk/modifiers/modifierMyMinionOrGeneralDamagedWatchBuffSelf.coffee
ModifierMyMoveWatch	Modifier	app/sdk/modifiers/modifierMyMoveWatch.coffee
ModifierMyMoveWatchAnyReason	Modifier	app/sdk/modifiers/modifierMyMoveWatchAnyReason.coffee
ModifierMyMoveWatchAnyReasonDamageNearbyEnemyMinions	ModifierMyMoveWatchAnyReason	app/sdk/modifiers/modifierMyMoveWatchAnyReasonDamageNearbyEnemyMinions.coffee
ModifierMyMoveWatchAnyReasonDrawCard	ModifierMyMoveWatchAnyReason	app/sdk/modifiers/modifierMyMoveWatchAnyReasonDrawCard.coffee
ModifierMyMoveWatchApplyModifiers	ModifierMyMoveWatch	app/sdk/modifiers/modifierMyMoveWatchApplyModifiers.coffee
ModifierMyMoveWatchDrawCard	ModifierMyMoveWatch	app/sdk/modifiers/modifierMyMoveWatchDrawCard.coffee
ModifierMyMoveWatchSpawnEntity	ModifierMyMoveWatch	app/sdk/modifiers/modifierMyMoveWatchSpawnEntity.coffee
ModifierMyOtherMinionsDamagedWatch	Modifier	app/sdk/modifiers/modifierMyOtherMinionsDamagedWatch.coffee
ModifierMyOtherMinionsDamagedWatchDamagedMinionGrows	ModifierMyOtherMinionsDamagedWatch	app/sdk/modifiers/modifierMyOtherMinionsDamagedWatchDamagedMinionGrows.coffee
ModifierMyTeamMoveWatchAnyReason	Modifier	app/sdk/modifiers/modifierMyTeamMoveWatchAnyReason.coffee
ModifierMyTeamMoveWatchAnyReasonBuffTarget	ModifierMyTeamMoveWatchAnyReason	app/sdk/modifiers/modifierMyTeamMoveWatchAnyReasonBuffTarget.coffee
ModifierNocturne	Modifier	app/sdk/modifiers/modifierNocturne.coffee
ModifierNoshRak	Modifier	app/sdk/modifiers/modifierNoshRak.coffee
ModifierObstructing	Modifier	app/sdk/modifiers/modifierObstructing.coffee
ModifierOnDying	Modifier	app/sdk/modifiers/modifierOnDying.coffee
ModifierOnDyingInfest	ModifierOnDying	app/sdk/modifiers/modifierOnDyingInfest.coffee
ModifierOnDyingResummonAnywhere	ModifierOnDying	app/sdk/modifiers/modifierOnDyingResummonAnywhere.coffee
ModifierOnDyingSpawnEntity	ModifierOnDying	app/sdk/modifiers/modifierOnDyingSpawnEntity.coffee
ModifierOnOpponentDeathWatch	ModifierDeathWatch	app/sdk/modifiers/modifierOnOpponentDeathWatch.coffee
ModifierOnOpponentDeathWatchSpawnEntityOnSpace	ModifierOnOpponentDeathWatch	app/sdk/modifiers/modifierOnOpponentDeathWatchSpawnEntityOnSpace.coffee
ModifierOnRemoveSpawnEntities	Modifier	app/sdk/modifiers/modifierOnRemoveSpawnEntities.coffee
ModifierOnRemoveSpawnRandomDeadEntity	Modifier	app/sdk/modifiers/modifierOnRemoveSpawnRandomDeadEntity.coffee
ModifierOnSpawnCopyMyGeneral	Modifier	app/sdk/modifiers/modifierOnSpawnCopyMyGeneral.coffee
ModifierOnSpawnKillMyGeneral	Modifier	app/sdk/modifiers/modifierOnSpawnKillMyGeneral.coffee
ModifierOnSummonFromHand	Modifier	app/sdk/modifiers/modifierOnSummonFromHand.coffee
ModifierOnSummonFromHandApplyEmblems	ModifierOnSummonFromHand	app/sdk/modifiers/modifierOnSummonFromHandApplyEmblems.coffee
ModifierOpeningGambit	Modifier	app/sdk/modifiers/modifierOpeningGambit.coffee
ModifierOpeningGambitActivateSignatureCard	ModifierOpeningGambit	app/sdk/modifiers/modifierOpeningGambitActivateSignatureCard.coffee
ModifierOpeningGambitAlabasterTitan	ModifierOpeningGambit	app/sdk/modifiers/modifierOpeningGambitAlabasterTitan.coffee
ModifierOpeningGambitApplyMechazorPlayerModifiers	ModifierOpeningGambitApplyPlayerModifiers	app/sdk/modifiers/modifierOpeningGambitApplyMechazorPlayerModifiers.coffee
ModifierOpeningGambitApplyModifiers	ModifierOpeningGambit	app/sdk/modifiers/modifierOpeningGambitApplyModifiers.coffee
ModifierOpeningGambitApplyModifiersByRaceId	ModifierOpeningGambitApplyModifiers	app/sdk/modifiers/modifierOpeningGambitApplyModifiersByRaceId.coffee
ModifierOpeningGambitApplyModifiersRandomly	ModifierOpeningGambitApplyModifiers	app/sdk/modifiers/modifierOpeningGambitApplyModifiersRandomly.coffee
ModifierOpeningGambitApplyModifiersToDeck	ModifierOpeningGambit	app/sdk/modifiers/modifierOpeningGambitApplyModifiersToDeck.coffee
ModifierOpeningGambitApplyModifiersToDeckAndHand	ModifierOpeningGambit	app/sdk/modifiers/modifierOpeningGambitApplyModifiersToDeckAndHand.coffee
ModifierOpeningGambitApplyModifiersToGeneral	ModifierOpeningGambit	app/sdk/modifiers/modifierOpeningGambitApplyModifiersToGeneral.coffee
ModifierOpeningGambitApplyModifiersToHand	ModifierOpeningGambitApplyModifiersToDeckAndHand	app/sdk/modifiers/modifierOpeningGambitApplyModifiersToHand.coffee
ModifierOpeningGambitApplyModifiersToWraithlings	ModifierOpeningGambitApplyModifiers	app/sdk/modifiers/modifierOpeningGambitApplyModifiersToWraithlings.coffee
ModifierOpeningGambitApplyPlayerModifiers	ModifierOpeningGambit	app/sdk/modifiers/modifierOpeningGambitApplyPlayerModifiers.coffee
ModifierOpeningGambitBonusManaCrystal	ModifierOpeningGambit	app/sdk/modifiers/modifierOpeningGambitBonusManaCrystal.coffee
ModifierOpeningGambitBuffSelfByBattlePetsHandStats	ModifierOpeningGambit	app/sdk/modifiers/modifierOpeningGambitBuffSelfByBattlePetsHandStats.coffee
ModifierOpeningGambitBuffSelfByOpponentHandCount	ModifierOpeningGambit	app/sdk/modifiers/modifierOpeningGambitBuffSelfByOpponentHandCount.coffee
ModifierOpeningGambitBuffSelfByShadowTileCount	ModifierOpeningGambit	app/sdk/modifiers/modifierOpeningGambitBuffSelfByShadowTileCount.coffee
ModifierOpeningGambitChangeSignatureCard	ModifierOpeningGambit	app/sdk/modifiers/modifierOpeningGambitChangeSignatureCard.coffee
ModifierOpeningGambitChangeSignatureCardForThisTurn	ModifierOpeningGambit	app/sdk/modifiers/modifierOpeningGambitChangeSignatureCardForThisTurn.coffee
ModifierOpeningGambitDagona	ModifierOpeningGambit	app/sdk/modifiers/modifierOpeningGambitDagona.coffee
ModifierOpeningGambitDamageBothGenerals	ModifierOpeningGambit	app/sdk/modifiers/modifierOpeningGambitDamageBothGenerals.coffee
ModifierOpeningGambitDamageEnemiesNearShadowCreep	ModifierOpeningGambit	app/sdk/modifiers/modifierOpeningGambitDamageEnemiesNearShadowCreep.coffee
ModifierOpeningGambitDamageEverything	ModifierOpeningGambit	app/sdk/modifiers/modifierOpeningGambitDamageEverything.coffee
ModifierOpeningGambitDamageInFront	ModifierOpeningGambit	app/sdk/modifiers/modifierOpeningGambitDamageInFront.coffee
ModifierOpeningGambitDamageInFrontRow	ModifierOpeningGambit	app/sdk/modifiers/modifierOpeningGambitDamageInFrontRow.coffee
ModifierOpeningGambitDamageMyGeneral	ModifierOpeningGambit	app/sdk/modifiers/modifierOpeningGambitDamageMyGeneral.coffee
ModifierOpeningGambitDamageNearby	ModifierOpeningGambit	app/sdk/modifiers/modifierOpeningGambitDamageNearby.coffee
ModifierOpeningGambitDamageNearbyForAttack	ModifierOpeningGambit	app/sdk/modifiers/modifierOpeningGambitDamageNearbyForAttack.coffee
ModifierOpeningGambitDamageNearbyMinions	ModifierOpeningGambit	app/sdk/modifiers/modifierOpeningGambitDamageNearbyMinions.coffee
ModifierOpeningGambitDeathKnell	ModifierOpeningGambit	app/sdk/modifiers/modifierOpeningGambitDeathKnell.coffee
ModifierOpeningGambitDestroyEnemyMinions	ModifierOpeningGambit	app/sdk/modifiers/modifierOpeningGambitDestroyEnemyMinions.coffee
ModifierOpeningGambitDestroyManaCrystal	ModifierOpeningGambit	app/sdk/modifiers/modifierOpeningGambitDestroyManaCrystal.coffee
ModifierOpeningGambitDestroyNearbyMinions	ModifierOpeningGambit	app/sdk/modifiers/modifierOpeningGambitDestroyNearbyMinions.coffee
ModifierOpeningGambitDispel	ModifierOpeningGambit	app/sdk/modifiers/modifierOpeningGambitDispel.coffee
ModifierOpeningGambitDrawArtifactFromDeck	ModifierOpeningGambit	app/sdk/modifiers/modifierOpeningGambitDrawArtifactFromDeck.coffee
ModifierOpeningGambitDrawCard	ModifierOpeningGambit	app/sdk/modifiers/modifierOpeningGambitDrawCard.coffee
ModifierOpeningGambitDrawCardBothPlayers	ModifierOpeningGambit	app/sdk/modifiers/modifierOpeningGambitDrawCardBothPlayers.coffee
ModifierOpeningGambitDrawCopyFromDeck	ModifierOpeningGambit	app/sdk/modifiers/modifierOpeningGambitDrawCopyFromDeck.coffee
ModifierOpeningGambitDrawFactionCards	ModifierOpeningGambit	app/sdk/modifiers/modifierOpeningGambitDrawFactionCards.coffee
ModifierOpeningGambitDrawRandomBattlePet	ModifierOpeningGambit	app/sdk/modifiers/modifierOpeningGambitDrawRandomBattlePet.coffee
ModifierOpeningGambitEquipArtifact	ModifierOpeningGambit	app/sdk/modifiers/modifierOpeningGambitEquipArtifact.coffee
ModifierOpeningGambitGoleminate	ModifierOpeningGambit	app/sdk/modifiers/modifierOpeningGambitGoleminate.coffee
ModifierOpeningGambitGrandmasterVariax	ModifierOpeningGambitChangeSignatureCard	app/sdk/modifiers/modifierOpeningGambitGrandmasterVariax.coffee
ModifierOpeningGambitGrincher	ModifierOpeningGambit	app/sdk/modifiers/modifierOpeningGambitGrincher.coffee
ModifierOpeningGambitHatchFriendlyEggs	ModifierOpeningGambit	app/sdk/modifiers/modifierOpeningGambitHatchFriendlyEggs.coffee
ModifierOpeningGambitHealBothGenerals	ModifierOpeningGambit	app/sdk/modifiers/modifierOpeningGambitHealBothGenerals.coffee
ModifierOpeningGambitHealMyGeneral	ModifierOpeningGambit	app/sdk/modifiers/modifierOpeningGambitHealMyGeneral.coffee
ModifierOpeningGambitLifeGive	ModifierOpeningGambit	app/sdk/modifiers/modifierOpeningGambitLifeGive.coffee
ModifierOpeningGambitMindwarp	ModifierOpeningGambit	app/sdk/modifiers/modifierOpeningGambitMindwarp.coffee
ModifierOpeningGambitMoveEnemyGeneralForward	ModifierOpeningGambit	app/sdk/modifiers/modifierOpeningGambitMoveEnemyGeneralForward.coffee
ModifierOpeningGambitProgenitor	ModifierOpeningGambit	app/sdk/modifiers/modifierOpeningGambitProgenitor.coffee
ModifierOpeningGambitProgressBuild	ModifierOpeningGambit	app/sdk/modifiers/modifierOpeningGambitProgressBuild.coffee
ModifierOpeningGambitPutCardInHand	ModifierOpeningGambit	app/sdk/modifiers/modifierOpeningGambitPutCardInHand.coffee
ModifierOpeningGambitPutCardInOpponentHand	ModifierOpeningGambit	app/sdk/modifiers/modifierOpeningGambitPutCardInOpponentHand.coffee
ModifierOpeningGambitRazorback	ModifierOpeningGambitApplyModifiers	app/sdk/modifiers/modifierOpeningGambitRazorback.coffee
ModifierOpeningGambitRefreshArtifacts	ModifierOpeningGambit	app/sdk/modifiers/modifierOpeningGambitRefreshArtifacts.coffee
ModifierOpeningGambitRefreshSignatureCard	ModifierOpeningGambit	app/sdk/modifiers/modifierOpeningGambitRefreshSignatureCard.coffee
ModifierOpeningGambitRemoveArtifactToDrawArtifactFromFaction	ModifierOpeningGambit	app/sdk/modifiers/modifierOpeningGambitRemoveArtifactToDrawArtifactFromFaction.coffee
ModifierOpeningGambitRemoveCardsFromDecksByCost	ModifierOpeningGambit	app/sdk/modifiers/modifierOpeningGambitRemoveCardsFromDecksByCost.coffee
ModifierOpeningGambitRemoveRandomArtifact	ModifierOpeningGambit	app/sdk/modifiers/modifierOpeningGambitRemoveRandomArtifact.coffee
ModifierOpeningGambitReplaceHand	ModifierOpeningGambit	app/sdk/modifiers/modifierOpeningGambitReplaceHand.coffee
ModifierOpeningGambitRetrieveMostRecentSpell	ModifierOpeningGambit	app/sdk/modifiers/modifierOpeningGambitRetrieveMostRecentSpell.coffee
ModifierOpeningGambitRetrieveRandomSpell	ModifierOpeningGambit	app/sdk/modifiers/modifierOpeningGambitRetrieveRandomSpell.coffee
ModifierOpeningGambitSacrificeNearbyBuffSelf	ModifierOpeningGambit	app/sdk/modifiers/modifierOpeningGambitSacrificeNearbyBuffSelf.coffee
ModifierOpeningGambitSirocco	ModifierOpeningGambit	app/sdk/modifiers/modifierOpeningGambitSirocco.coffee
ModifierOpeningGambitSniperZen	ModifierOpeningGambit	app/sdk/modifiers/modifierOpeningGambitSniperZen.coffee
ModifierOpeningGambitSpawnCopiesOfEntityAnywhere	ModifierOpeningGambit	app/sdk/modifiers/modifierOpeningGambitSpawnCopiesOfEntityAnywhere.coffee
ModifierOpeningGambitSpawnCopiesOfEntityNearby	ModifierOpeningGambit	app/sdk/modifiers/modifierOpeningGambitSpawnCopiesOfEntityNearby.coffee
ModifierOpeningGambitSpawnEnemyMinionNearOpponent	ModifierOpeningGambit	app/sdk/modifiers/modifierOpeningGambitSpawnEnemyMinionNearOpponent.coffee
ModifierOpeningGambitSpawnEntity	ModifierOpeningGambit	app/sdk/modifiers/modifierOpeningGambitSpawnEntity.coffee
ModifierOpeningGambitSpawnEntityInEachCorner	ModifierOpeningGambit	app/sdk/modifiers/modifierOpeningGambitSpawnEntityInEachCorner.coffee
ModifierOpeningGambitSpawnPartyAnimals	ModifierOpeningGambit	app/sdk/modifiers/modifierOpeningGambitSpawnPartyAnimals.coffee
ModifierOpeningGambitSpawnTribal	ModifierOpeningGambit	app/sdk/modifiers/modifierOpeningGambitSpawnTribal.coffee
ModifierOpeningGambitSpawnVanarTokensAroundGeneral	ModifierOpeningGambit	app/sdk/modifiers/modifierOpeningGambitSpawnVanarTokensAroundGeneral.coffee
ModifierOpeningGambitStealEnemyGeneralHealth	ModifierOpeningGambit	app/sdk/modifiers/modifierOpeningGambitStealEnemyGeneralHealth.coffee
OpeningGambitTeleportAllNearby	ModifierOpeningGambit	app/sdk/modifiers/modifierOpeningGambitTeleportAllNearby.coffee
ModifierOpeningGambitTeleportMinionsToThis	ModifierOpeningGambit	app/sdk/modifiers/modifierOpeningGambitTeleportMinionsToThis.coffee
ModifierOpeningGambitTransformHandIntoLegendaries	ModifierOpeningGambit	app/sdk/modifiers/modifierOpeningGambitTransformHandIntoLegendaries.coffee
ModifierOpponentDrawCardWatch	Modifier	app/sdk/modifiers/modifierOpponentDrawCardWatch.coffee
ModifierOpponentDrawCardWatchBuffSelf	ModifierOpponentDrawCardWatch	app/sdk/modifiers/modifierOpponentDrawCardWatchBuffSelf.coffee
ModifierOpponentDrawCardWatchDamageEnemyGeneral	ModifierOpponentDrawCardWatch	app/sdk/modifiers/modifierOpponentDrawCardWatchDamageEnemyGeneral.coffee
ModifierOpponentDrawCardWatchGainKeyword	ModifierOpponentDrawCardWatch	app/sdk/modifiers/modifierOpponentDrawCardWatchGainKeyword.coffee
ModifierOpponentDrawCardWatchOverdrawSummonEntity	ModifierOpponentDrawCardWatch	app/sdk/modifiers/modifierOpponentDrawCardWatchOverdrawSummonEntity.coffee
ModifierOpponentSummonWatch	Modifier	app/sdk/modifiers/modifierOpponentSummonWatch.coffee
ModifierOpponentSummonWatchDamageBuffMinionInHand	ModifierOpponentSummonWatch	app/sdk/modifiers/modifierOpponentSummonWatchBuffMinionInHand.coffee
ModifierOpponentSummonWatchBuffSelf	ModifierOpponentSummonWatch	app/sdk/modifiers/modifierOpponentSummonWatchBuffSelf.coffee
ModifierOpponentSummonWatchDamageEnemyGeneral	ModifierOpponentSummonWatch	app/sdk/modifiers/modifierOpponentSummonWatchDamageEnemyGeneral.coffee
ModifierOpponentSummonWatchOpponentDrawCard	ModifierOpponentSummonWatch	app/sdk/modifiers/modifierOpponentSummonWatchOpponentDrawCard.coffee
ModifierOpponentSummonWatchRandomTransform	ModifierOpponentSummonWatch	app/sdk/modifiers/modifierOpponentSummonWatchRandomTransform.coffee
ModifierOpponentSummonWatchSpawn1HealthClone	ModifierOpponentSummonWatch	app/sdk/modifiers/modifierOpponentSummonWatchSpawn1HealthClone.coffee
ModifierOpponentSummonWatchSummonEgg	ModifierOpponentSummonWatch	app/sdk/modifiers/modifierOpponentSummonWatchSummonEgg.coffee
ModifierOpponentSummonWatchSummonMinionInFront	ModifierOpponentSummonWatch	app/sdk/modifiers/modifierOpponentSummonWatchSummonMinionInFront.coffee
ModifierOpponentSummonWatchSwapGeneral	ModifierOpponentSummonWatch	app/sdk/modifiers/modifierOpponentSummonWatchSwapGeneral.coffee
ModifierOverwatch	Modifier	app/sdk/modifiers/modifierOverwatch.coffee
ModifierOverwatchAttacked	ModifierOverwatch	app/sdk/modifiers/modifierOverwatchAttacked.coffee
ModifierOverwatchAttackedBuffSelf	ModifierOverwatchAttacked	app/sdk/modifiers/modifierOverwatchAttackedBuffSelf.coffee
ModifierOverwatchAttackedDamageEnemyGeneralForSame	ModifierOverwatchAttacked	app/sdk/modifiers/modifierOverwatchAttackedDamageEnemyGeneralForSame.coffee
ModifierOverwatchDestroyed	ModifierOverwatch	app/sdk/modifiers/modifierOverwatchDestroyed.coffee
ModifierOverwatchDestroyedPutCardInHand	ModifierOverwatchDestroyed	app/sdk/modifiers/modifierOverwatchDestroyedPutCardInHand.coffee
ModifierOverwatchDestroyedPutMagmarCardsInHand	ModifierOverwatchDestroyed	app/sdk/modifiers/modifierOverwatchDestroyedPutMagmarCardsInHand.coffee
ModifierOverwatchDestroyedResummonAndDestroyOther	ModifierOverwatchDestroyed	app/sdk/modifiers/modifierOverwatchDestroyedResummonAndDestroyOther.coffee
ModifierOverwatchEndTurn	ModifierOverwatch	app/sdk/modifiers/modifierOverwatchEndTurn.coffee
ModifierOverwatchEndTurnPutCardInHand	ModifierOverwatchEndTurn	app/sdk/modifiers/modifierOverwatchEndTurnPutCardInHand.coffee
ModifierOverwatchHidden	Modifier	app/sdk/modifiers/modifierOverwatchHidden.coffee
ModifierOverwatchMovedNearby	ModifierOverwatch	app/sdk/modifiers/modifierOverwatchMovedNearby.coffee
ModifierOverwatchMovedNearbyAttack	ModifierOverwatchMovedNearby	app/sdk/modifiers/modifierOverwatchMovedNearbyAttack.coffee
ModifierOverwatchMovedNearbyDispelAndProvoke	ModifierOverwatchMovedNearby	app/sdk/modifiers/modifierOverwatchMovedNearbyDispelAndProvoke.coffee
ModifierOverwatchMovedNearbyMiniImmolation	ModifierOverwatchMovedNearby	app/sdk/modifiers/modifierOverwatchMovedNearbyMiniImmolation.coffee
ModifierOverwatchMovedNearbyMoveBothToCorners	ModifierOverwatchMovedNearby	app/sdk/modifiers/modifierOverwatchMovedNearbyMoveBothToCorners.coffee
ModifierOverwatchSpellTarget	ModifierOverwatch	app/sdk/modifiers/modifierOverwatchSpellTarget.coffee
ModifierOverwatchSpellTargetDamageEnemies	ModifierOverwatchSpellTarget	app/sdk/modifiers/modifierOverwatchSpellTargetDamageEnemies.coffee
ModifierPantheran	Modifier	app/sdk/modifiers/modifierPantheran.coffee
ModifierPortal	Modifier	app/sdk/modifiers/modifierPortal.coffee
ModifierPrimalProtection	Modifier	app/sdk/modifiers/modifierPrimalProtection.coffee
ModifierPrimalTile	Modifier	app/sdk/modifiers/modifierPrimalTile.coffee
ModifierProvidesAlwaysInfiltrated	Modifier	app/sdk/modifiers/modifierProvidesAlwaysInfiltrated.coffee
ModifierProvoke	Modifier	app/sdk/modifiers/modifierProvoke.coffee
ModifierProvoked	Modifier	app/sdk/modifiers/modifierProvoked.coffee
ModifierPseudoRush	Modifier	app/sdk/modifiers/modifierPseudoRush.coffee
ModifierQuestBuffAbyssian	ModifierOnDyingResummonAnywhere	app/sdk/modifiers/modifierQuestBuffAbyssian.coffee
ModifierQuestBuffNeutral	Modifier	app/sdk/modifiers/modifierQuestBuffNeutral.coffee
ModifierQuestBuffVanar	Modifier	app/sdk/modifiers/modifierQuestBuffVanar.coffee
ModifierQuestStatus	Modifier	app/sdk/modifiers/modifierQuestStatus.coffee
ModifierQuestStatusAbyssian	ModifierQuestStatus	app/sdk/modifiers/modifierQuestStatusAbyssian.coffee
ModifierQuestStatusLyonar	ModifierQuestStatus	app/sdk/modifiers/modifierQuestStatusLyonar.coffee
ModifierQuestStatusMagmar	ModifierQuestStatus	app/sdk/modifiers/modifierQuestStatusMagmar.coffee
ModifierQuestStatusNeutral	ModifierQuestStatus	app/sdk/modifiers/modifierQuestStatusNeutral.coffee
ModifierQuestStatusSonghai	ModifierQuestStatus	app/sdk/modifiers/modifierQuestStatusSonghai.coffee
ModifierQuestStatusVanar	ModifierQuestStatus	app/sdk/modifiers/modifierQuestStatusVanar.coffee
ModifierQuestStatusVetruvian	ModifierQuestStatus	app/sdk/modifiers/modifierQuestStatusVetruvian.coffee
ModifierRanged	Modifier	app/sdk/modifiers/modifierRanged.coffee
ModifierRangedProvoke	Modifier	app/sdk/modifiers/modifierRangedProvoke.coffee
ModifierRangedProvoked	Modifier	app/sdk/modifiers/modifierRangedProvoked.coffee
ModifierRebirth	ModifierOnDyingSpawnEntity	app/sdk/modifiers/modifierRebirth.coffee
ModifierReduceCostOfMinionsAndDamageThem	ModifierSummonWatch	app/sdk/modifiers/modifierReduceCostOfMinionsAndDamageThem.coffee
ModifierRemoveAndReplaceEntity	Modifier	app/sdk/modifiers/modifierRemoveAndReplaceEntity.coffee
ModifierReplaceWatch	Modifier	app/sdk/modifiers/modifierReplaceWatch.coffee
ModifierReplaceWatchApplyModifiersToReplaced	ModifierReplaceWatch	app/sdk/modifiers/modifierReplaceWatchApplyModifiersToReplaced.coffee
ModifierReplaceWatchBuffSelf	ModifierReplaceWatch	app/sdk/modifiers/modifierReplaceWatchBuffSelf.coffee
ModifierReplaceWatchDamageEnemy	ModifierReplaceWatch	app/sdk/modifiers/modifierReplaceWatchDamageEnemy.coffee
ModifierReplaceWatchShuffleCardIntoDeck	ModifierReplaceWatch	app/sdk/modifiers/modifierReplaceWatchShuffleCardIntoDeck.coffee
ModifierReplaceWatchSpawnEntity	ModifierReplaceWatch	app/sdk/modifiers/modifierReplaceWatchSpawnEntity.coffee
ModifierRook	ModifierEndTurnWatch	app/sdk/modifiers/modifierRook.coffee
ModifierSandPortal	ModifierSummonWatchFromActionBar	app/sdk/modifiers/modifierSandPortal.coffee
ModifierSecondWind	Modifier	app/sdk/modifiers/modifierSecondWind.coffee
ModifierSelfDamageAreaAttack	Modifier	app/sdk/modifiers/modifierSelfDamageAreaAttack.coffee
ModifierSentinel	ModifierOverwatch	app/sdk/modifiers/modifierSentinel.coffee
ModifierSentinelHidden	ModifierOverwatchHidden	app/sdk/modifiers/modifierSentinelHidden.coffee
ModifierSentinelOpponentGeneralAttack	ModifierSentinel	app/sdk/modifiers/modifierSentinelOpponentGeneralAttack.coffee
ModifierSentinelOpponentGeneralAttackHealEnemyGeneralDrawCard	ModifierSentinel	app/sdk/modifiers/modifierSentinelOpponentGeneralAttackHealEnemyGeneralDrawCard.coffee
ModifierSentinelOpponentSpellCast	ModifierSentinel	app/sdk/modifiers/modifierSentinelOpponentSpellCast.coffee
ModifierSentinelOpponentSpellCastRefundManaDrawCard	ModifierSentinel	app/sdk/modifiers/modifierSentinelOpponentSpellCastRefundManaDrawCard.coffee
ModifierSentinelOpponentSummon	ModifierSentinel	app/sdk/modifiers/modifierSentinelOpponentSummon.coffee
ModifierSentinelOpponentSummonBuffItDrawCard	ModifierSentinelOpponentSummon	app/sdk/modifiers/modifierSentinelOpponentSummonBuffItDrawCard.coffee
ModifierSentinelOpponentSummonCopyIt	ModifierSentinelOpponentSummon	app/sdk/modifiers/modifierSentinelOpponentSummonCopyIt.coffee
ModifierSentinelOpponentSummonDamageIt	ModifierSentinelOpponentSummon	app/sdk/modifiers/modifierSentinelOpponentSummonDamageIt.coffee
ModifierSentinelOpponentSummonSwapPlaces	ModifierSentinelOpponentSummon	app/sdk/modifiers/modifierSentinelOpponentSummonSwapPlaces.coffee
ModifierSentinelSetup	Modifier	app/sdk/modifiers/modifierSentinelSetup.coffee
ModifierShadowScar	ModifierDyingWish	app/sdk/modifiers/modifierShadowScar.coffee
ModifierShatteringHeart	Modifier	app/sdk/modifiers/modifierShatteringHeart.coffee
ModifierSilence	Modifier	app/sdk/modifiers/modifierSilence.coffee
ModifierSituationalBuffSelf	Modifier	app/sdk/modifiers/modifierSituationalBuffSelf.coffee
ModifierSituationalBuffSelfIfFullHealth	ModifierSituationalBuffSelf	app/sdk/modifiers/modifierSituationalBuffSelfIfFullHealth.coffee
ModifierSituationalBuffSelfIfHaveMech	ModifierSituationalBuffSelf	app/sdk/modifiers/modifierSituationalBuffSelfIfHaveMech.coffee
ModifierSituationalBuffSelfIfSpriggin	ModifierSituationalBuffSelf	app/sdk/modifiers/modifierSituationalBuffSelfIfSpriggin.coffee
ModifierSnowRippler	ModifierDealDamageWatch	app/sdk/modifiers/modifierSnowRippler.coffee
ModifierSpawnedFromEgg	Modifier	app/sdk/modifiers/modifierSpawnedFromEgg.coffee
ModifierSpellDamageWatch	Modifier	app/sdk/modifiers/modifierSpellDamageWatch.coffee
ModifierSpellDamageWatchPutCardInHand	ModifierSpellDamageWatch	app/sdk/modifiers/modifierSpellDamageWatchPutCardInHand.coffee
ModifierSpellWatch	Modifier	app/sdk/modifiers/modifierSpellWatch.coffee
ModifierSpellWatchAnywhereApplyModifiers	Modifier	app/sdk/modifiers/modifierSpellWatchAnywhereApplyModifiers.coffee
ModifierSpellWatchApplyModifiers	ModifierSpellWatch	app/sdk/modifiers/modifierSpellWatchApplyModifiers.coffee
ModifierSpellWatchBloodLeech	ModifierSpellWatch	app/sdk/modifiers/modifierSpellWatchBloodLeech.coffee
ModifierSpellWatchBuffAllies	ModifierSpellWatch	app/sdk/modifiers/modifierSpellWatchBuffAllies.coffee
ModifierSpellWatchBuffAlliesByRace	ModifierSpellWatch	app/sdk/modifiers/modifierSpellWatchBuffAlliesByRace.coffee
ModifierSpellWatchDamageAllMinions	ModifierSpellWatch	app/sdk/modifiers/modifierSpellWatchDamageAllMinions.coffee
ModifierSpellWatchDamageGeneral	ModifierSpellWatch	app/sdk/modifiers/modifierSpellWatchDamageGeneral.coffee
ModifierSpellWatchDrawCard	ModifierSpellWatch	app/sdk/modifiers/modifierSpellWatchDrawCard.coffee
ModifierSpellWatchDrawRandomArcanyst	ModifierSpellWatch	app/sdk/modifiers/modifierSpellWatchDrawRandomArcanyst.coffee
ModifierSpellWatchPutCardInHand	ModifierSpellWatch	app/sdk/modifiers/modifierSpellWatchPutCardInHand.coffee
ModifierSpellWatchScientist	Modifier	app/sdk/modifiers/modifierSpellWatchScientist.coffee
ModifierSpellWatchSpawnEntity	ModifierSpellWatch	app/sdk/modifiers/modifierSpellWatchSpawnEntity.coffee
ModifierSpiritScribe	ModifierSummonWatch	app/sdk/modifiers/modifierSpiritScribe.coffee
ModifierSprigginDiesBuffSelf	Modifier	app/sdk/modifiers/modifierSprigginDiesBuffSelf.coffee
ModifierStackingShadows	ModifierEndTurnWatch	app/sdk/modifiers/modifierStackingShadows.coffee
ModifierStackingShadowsBonusDamage	Modifier	app/sdk/modifiers/modifierStackingShadowsBonusDamage.coffee
ModifierStackingShadowsBonusDamageEqualNumberTiles	ModifierStackingShadowsBonusDamage	app/sdk/modifiers/modifierStackingShadowsBonusDamageEqualNumberTiles.coffee
ModifierStackingShadowsBonusDamageUnique	ModifierStackingShadowsBonusDamage	app/sdk/modifiers/modifierStackingShadowsBonusDamageUnique.coffee
ModifierStackingShadowsDebuff	Modifier	app/sdk/modifiers/modifierStackingShadowsDebuff.coffee
ModifierStartOpponentsTurnWatch	Modifier	app/sdk/modifiers/modifierStartOpponentsTurnWatch.coffee
ModifierStartOpponentsTurnWatchRemoveEntity	ModifierStartOpponentsTurnWatch	app/sdk/modifiers/modifierStartOpponentsTurnWatchRemoveEntity.coffee
ModifierStartTurnWatch	Modifier	app/sdk/modifiers/modifierStartTurnWatch.coffee
ModifierStartTurnWatchApplyTempArtifactModifier	ModifierStartTurnWatch	app/sdk/modifiers/modifierStartTurnWatchApplyTempArtifactModifier.coffee
ModifierStartTurnWatchBounceToActionBar	ModifierStartTurnWatch	app/sdk/modifiers/modifierStartTurnWatchBounceToActionBar.coffee
ModifierStartTurnWatchBuffSelf	ModifierStartTurnWatch	app/sdk/modifiers/modifierStartTurnWatchBuffSelf.coffee
ModifierStartTurnWatchDamageAndBuffSelf	ModifierStartTurnWatchBuffSelf	app/sdk/modifiers/modifierStartTurnWatchDamageAndBuffSelf.coffee
ModifierStartTurnWatchDamageEnemiesInRow	ModifierStartTurnWatch	app/sdk/modifiers/modifierStartTurnWatchDamageEnemiesInRow.coffee
ModifierStartTurnWatchDamageEnemyGeneralBuffSelf	ModifierStartTurnWatchBuffSelf	app/sdk/modifiers/modifierStartTurnWatchDamageEnemyGeneralBuffSelf.coffee
ModifierStartTurnWatchDamageGeneralEqualToMinionsOwned	ModifierStartTurnWatch	app/sdk/modifiers/modifierStartTurnWatchDamageGeneralEqualToMinionsOwned.coffee
ModifierStartTurnWatchDamageMyGeneral	ModifierStartTurnWatch	app/sdk/modifiers/modifierStartTurnWatchDamageMyGeneral.coffee
ModifierStartTurnWatchDamageRandom	ModifierStartTurnWatch	app/sdk/modifiers/modifierStartTurnWatchDamageRandom.coffee
ModifierStartTurnWatchDestroySelfAndEnemies	ModifierStartTurnWatch	app/sdk/modifiers/modifierStartTurnWatchDestroySelfAndEnemies.coffee
ModifierStartTurnWatchDispelAllEnemyMinionsDrawCard	ModifierStartTurnWatch	app/sdk/modifiers/modifierStartTurnWatchDispelAllEnemyMinionsDrawCard.coffee
ModifierStartTurnWatchEquipArtifact	ModifierStartTurnWatch	app/sdk/modifiers/modifierStartTurnWatchEquipArtifact.coffee
ModifierStartTurnWatchImmolateDamagedMinions	ModifierStartTurnWatch	app/sdk/modifiers/modifierStartTurnWatchImmolateDamagedMinions.coffee
ModifierStartTurnWatchPlaySpell	ModifierStartTurnWatch	app/sdk/modifiers/modifierStartTurnWatchPlaySpell.coffee
ModifierStartTurnWatchPutCardInHand	ModifierStartTurnWatch	app/sdk/modifiers/modifierStartTurnWatchPutCardInHand.coffee
ModifierStartTurnWatchPutCardInOpponentsHand	ModifierStartTurnWatch	app/sdk/modifiers/modifierStartTurnWatchPutCardInOpponentsHand.coffee
ModifierStartTurnWatchRemoveEntity	ModifierStartTurnWatch	app/sdk/modifiers/modifierStartTurnWatchRemoveEntity.coffee
ModifierStartTurnWatchRespawnClones	ModifierStartTurnWatch	app/sdk/modifiers/modifierStartTurnWatchRespawnClones.coffee
ModifierStartTurnWatchRestoreChargeToArtifacts	ModifierStartTurnWatch	app/sdk/modifiers/modifierStartTurnWatchRestoreChargeToArtifacts.coffee
ModifierStartTurnWatchSpawnEntity	ModifierStartTurnWatch	app/sdk/modifiers/modifierStartTurnWatchSpawnEntity.coffee
ModifierStartTurnWatchSpawnTile	ModifierStartTurnWatchSpawnEntity	app/sdk/modifiers/modifierStartTurnWatchSpawnTile.coffee
ModifierStartTurnWatchSummonDervish	ModifierStartTurnWatchSpawnEntity	app/sdk/modifiers/modifierStartTurnWatchSummonDervish.coffee
ModifierStartTurnWatchSwapStats	ModifierStartTurnWatch	app/sdk/modifiers/modifierStartTurnWatchSwapStats.coffee
ModifierStartTurnWatchTeleportRandomSpace	ModifierStartTurnWatch	app/sdk/modifiers/modifierStartTurnWatchTeleportRandomSpace.coffee
ModifierStartsInHand	Modifier	app/sdk/modifiers/modifierStartsInHand.coffee
ModifierStrikeback	Modifier	app/sdk/modifiers/modifierStrikeback.coffee
ModifierStun	ModifierStunned	app/sdk/modifiers/modifierStun.coffee
ModifierStunWhenAttacked	Modifier	app/sdk/modifiers/modifierStunWhenAttacked.coffee
ModifierStunned	Modifier	app/sdk/modifiers/modifierStunned.coffee
ModifierStunnedVanar	ModifierStunned	app/sdk/modifiers/modifierStunnedVanar.coffee
ModifierSummonSelfOnReplace	Modifier	app/sdk/modifiers/modifierSummonSelfOnReplace.coffee
ModifierSummonWatch	Modifier	app/sdk/modifiers/modifierSummonWatch.coffee
ModifierSummonWatchAnyPlayer	Modifier	app/sdk/modifiers/modifierSummonWatchAnyPlayer.coffee
ModifierSummonWatchAnyPlayerApplyModifiers	ModifierSummonWatchAnyPlayer	app/sdk/modifiers/modifierSummonWatchAnyPlayerApplyModifiers.coffee
ModifierSummonWatchAnyPlayerHsuku	ModifierSummonWatchAnyPlayer	app/sdk/modifiers/modifierSummonWatchAnyPlayerHsuku.coffee
ModifierSummonWatchAnywhereByRaceBuffSelf	ModifierSummonWatchByRaceBuffSelf	app/sdk/modifiers/modifierSummonWatchAnywhereByRaceBuffSelf.coffee
ModifierSummonWatchApplyModifiers	ModifierSummonWatch	app/sdk/modifiers/modifierSummonWatchApplyModifiers.coffee
ModifierSummonWatchApplyModifiersToBoth	ModifierSummonWatch	app/sdk/modifiers/modifierSummonWatchApplyModifiersToBoth.coffee
ModifierSummonWatchApplyModifiersToRanged	ModifierSummonWatchApplyModifiers	app/sdk/modifiers/modifierSummonWatchApplyModifiersToRanged.coffee
ModifierSummonWatchBuffSelf	ModifierSummonWatch	app/sdk/modifiers/modifierSummonWatchBuffSelf.coffee
ModifierSummonWatchBurnOpponentCards	ModifierSummonWatch	app/sdk/modifiers/modifierSummonWatchBurnOpponentCards.coffee
ModifierSummonWatchByCardBuffTarget	ModifierSummonWatch	app/sdk/modifiers/modifierSummonWatchByCardBuffTarget.coffee
ModifierSummonWatchByEntityBuffSelf	ModifierSummonWatch	app/sdk/modifiers/modifierSummonWatchByEntityBuffSelf.coffee
ModifierSummonWatchByRaceBuffSelf	ModifierSummonWatch	app/sdk/modifiers/modifierSummonWatchByRaceBuffSelf.coffee
ModifierSummonWatchByRaceDamageEnemyMinion	ModifierSummonWatch	app/sdk/modifiers/modifierSummonWatchByRaceDamageEnemyMinion.coffee
ModifierSummonWatchByRaceHealToFull	ModifierSummonWatch	app/sdk/modifiers/modifierSummonWatchByRaceHealToFull.coffee
ModifierSummonWatchByRaceSummonCopy	ModifierSummonWatch	app/sdk/modifiers/modifierSummonWatchByRaceSummonCopy.coffee
ModifierSummonWatchDreadnaught	ModifierSummonWatchByCardBuffTarget	app/sdk/modifiers/modifierSummonWatchDreadnaught.coffee
ModifierSummonWatchFromActionBar	ModifierSummonWatch	app/sdk/modifiers/modifierSummonWatchFromActionBar.coffee
ModifierSummonWatchFromActionBarAnyPlayer	Modifier	app/sdk/modifiers/modifierSummonWatchFromActionBarAnyPlayer.coffee
ModifierSummonWatchFromActionBarAnyPlayerApplyModifiers	ModifierSummonWatchFromActionBarAnyPlayer	app/sdk/modifiers/modifierSummonWatchFromActionBarAnyPlayerApplyModifiers.coffee
ModifierSummonWatchFromActionBarApplyModifiers	ModifierSummonWatchApplyModifiers	app/sdk/modifiers/modifierSummonWatchFromActionBarApplyModifiers.coffee
ModifierSummonWatchFromActionBarByOpeningGambitBuffSelf	ModifierSummonWatch	app/sdk/modifiers/modifierSummonWatchFromActionBarByOpeningGambitBuffSelf.coffee
ModifierSummonWatchFromActionBarByRaceBothPlayersDraw	ModifierSummonWatchFromActionBar	app/sdk/modifiers/modifierSummonWatchFromActionBarByRaceBothPlayersDraw.coffee
ModifierSummonWatchFromActionBarSpawnEntity	ModifierSummonWatchSpawnEntity	app/sdk/modifiers/modifierSummonWatchFromActionBarSpawnEntity.coffee
ModifierSummonWatchFromEggApplyModifiers	Modifier	app/sdk/modifiers/modifierSummonWatchFromEggApplyModifiers.coffee
ModifierSummonWatchHealSelf	ModifierSummonWatch	app/sdk/modifiers/modifierSummonWatchHealSelf.coffee
ModifierSummonWatchHydrax	ModifierSummonWatch	app/sdk/modifiers/modifierSummonWatchHydrax.coffee
ModifierSummonWatchIfLowAttackSummonedBuffSelf	ModifierSummonWatch	app/sdk/modifiers/modifierSummonWatchIfLowAttackSummonedBuffSelf.coffee
ModifierSummonWatchMechsShareKeywords	ModifierSummonWatch	app/sdk/modifiers/modifierSummonWatchMechsShareKeywords.coffee
ModifierSummonWatchNearbyAnyPlayerApplyModifiers	ModifierSummonWatchAnyPlayerApplyModifiers	app/sdk/modifiers/modifierSummonWatchNearbyAnyPlayerApplyModifiers.coffee
ModifierSummonWatchNearbyApplyModifiers	ModifierSummonWatchApplyModifiers	app/sdk/modifiers/modifierSummonWatchNearbyApplyModifiers.coffee
ModifierSummonWatchNearbyApplyModifiersOncePerTurn	ModifierSummonWatchNearbyApplyModifiers	app/sdk/modifiers/modifierSummonWatchNearbyApplyModifiersOncePerTurn.coffee
ModifierSummonWatchNearbyApplyModifiersToBoth	ModifierSummonWatchApplyModifiersToBoth	app/sdk/modifiers/modifierSummonWatchNearbyApplyModifiersToBoth.coffee
ModifierSummonWatchNearbyTransform	ModifierSummonWatchTransform	app/sdk/modifiers/modifierSummonWatchNearbyTransform.coffee
ModifierSummonWatchPutCardInHand	ModifierSummonWatch	app/sdk/modifiers/modifierSummonWatchPutCardInHand.coffee
ModifierSummonWatchSpawnEntity	ModifierSummonWatch	app/sdk/modifiers/modifierSummonWatchSpawnEntity.coffee
ModifierSummonWatchTransform	ModifierSummonWatch	app/sdk/modifiers/modifierSummonWatchTransform.coffee
ModifierSurviveDamageWatch	Modifier	app/sdk/modifiers/modifierSurviveDamageWatch.coffee
ModifierSurviveDamageWatchBur	ModifierSurviveDamageWatch	app/sdk/modifiers/modifierSurviveDamageWatchBur.coffee
ModifierSurviveDamageWatchReturnToHand	ModifierSurviveDamageWatch	app/sdk/modifiers/modifierSurviveDamageWatchReturnToHand.coffee
ModifierSwitchAllegiancesGainAttack	Modifier	app/sdk/modifiers/modifierSwitchAllegiancesGainAttack.coffee
ModifierSynergize	Modifier	app/sdk/modifiers/modifierSynergize.coffee
ModifierSynergizeApplyModifiers	ModifierSynergize	app/sdk/modifiers/modifierSynergizeApplyModifiers.coffee
ModifierSynergizeApplyModifiersToGeneral	ModifierSynergize	app/sdk/modifiers/modifierSynergizeApplyModifiersToGeneral.coffee
ModifierSynergizeApplyModifiersToWraithlings	ModifierSynergizeApplyModifiers	app/sdk/modifiers/modifierSynergizeApplyModifiersToWraithlings.coffee
ModifierSynergizeBuffSelf	ModifierSynergize	app/sdk/modifiers/modifierSynergizeBuffSelf.coffee
ModifierSynergizeDamageClosestEnemy	ModifierSynergize	app/sdk/modifiers/modifierSynergizeDamageClosestEnemy.coffee
ModifierSynergizeDamageEnemy	ModifierSynergize	app/sdk/modifiers/modifierSynergizeDamageEnemy.coffee
ModifierSynergizeDamageEnemyGeneral	ModifierSynergize	app/sdk/modifiers/modifierSynergizeDamageEnemyGeneral.coffee
ModifierSynergizeDrawBloodboundSpell	ModifierSynergize	app/sdk/modifiers/modifierSynergizeDrawBloodboundSpell.coffee
ModifierSynergizeHealMyGeneral	ModifierSynergize	app/sdk/modifiers/modifierSynergizeHealMyGeneral.coffee
ModifierSynergizePutCardInHand	ModifierSynergize	app/sdk/modifiers/modifierSynergizePutCardInHand.coffee
ModifierSynergizeRazorArchitect	ModifierSynergize	app/sdk/modifiers/modifierSynergizeRazorArchitect.coffee
ModifierSynergizeRefreshSpell	ModifierSynergize	app/sdk/modifiers/modifierSynergizeRefreshSpell.coffee
ModifierSynergizeSpawnEntityFromDeck	Modifier	app/sdk/modifiers/modifierSynergizeSpawnEntityFromDeck.coffee
ModifierSynergizeSpawnVanarToken	ModifierSynergize	app/sdk/modifiers/modifierSynergizeSpawnVanarToken.coffee
ModifierSynergizeSummonMinionNearGeneral	ModifierSynergize	app/sdk/modifiers/modifierSynergizeSummonMinionNearGeneral.coffee
ModifierSynergizeSummonMinionNearby	ModifierSynergize	app/sdk/modifiers/modifierSynergizeSummonMinionNearby.coffee
ModifierSynergizeTeleportRandomEnemy	ModifierSynergize	app/sdk/modifiers/modifierSynergizeTeleportRandomEnemy.coffee
ModifierTakeDamageWatch	Modifier	app/sdk/modifiers/modifierTakeDamageWatch.coffee
ModifierTakeDamageWatchDamageAllEnemies	ModifierTakeDamageWatch	app/sdk/modifiers/modifierTakeDamageWatchDamageAllEnemies.coffee
ModifierTakeDamageWatchDamageAttacker	ModifierTakeDamageWatch	app/sdk/modifiers/modifierTakeDamageWatchDamageAttacker.coffee
ModifierTakeDamageWatchDamageEnemy	ModifierTakeDamageWatch	app/sdk/modifiers/modifierTakeDamageWatchDamageEnemy.coffee
ModifierTakeDamageWatchDamageEnemyGeneralForSame	ModifierTakeDamageWatch	app/sdk/modifiers/modifierTakeDamageWatchDamageEnemyGeneralForSame.coffee
ModifierTakeDamageWatchDamageNearbyEnemiesForSame	ModifierTakeDamageWatch	app/sdk/modifiers/modifierTakeDamageWatchDamageNearbyEnemiesForSame.coffee
ModifierTakeDamageWatchDestroy	ModifierTakeDamageWatch	app/sdk/modifiers/modifierTakeDamageWatchDestroy.coffee
ModifierTakeDamageWatchDispel	ModifierTakeDamageWatch	app/sdk/modifiers/modifierTakeDamageWatchDispel.coffee
ModifierTakeDamageWatchHealMyGeneral	ModifierTakeDamageWatch	app/sdk/modifiers/modifierTakeDamageWatchHealMyGeneral.coffee
ModifierTakeDamageWatchJuggernaut	ModifierTakeDamageWatch	app/sdk/modifiers/modifierTakeDamageWatchJuggernaut.coffee
ModifierTakeDamageWatchOpponentDrawCard	ModifierTakeDamageWatch	app/sdk/modifiers/modifierTakeDamageWatchOpponentDrawCard.coffee
ModifierTakeDamageWatchPutCardInHand	ModifierTakeDamageWatch	app/sdk/modifiers/modifierTakeDamageWatchPutCardInHand.coffee
ModifierTakeDamageWatchRandomTeleport	ModifierTakeDamageWatch	app/sdk/modifiers/modifierTakeDamageWatchRandomTeleport.coffee
ModifierTakeDamageWatchSpawnEntity	ModifierTakeDamageWatch	app/sdk/modifiers/modifierTakeDamageWatchSpawnEntity.coffee
ModifierTakeDamageWatchSpawnRandomBattlePet	ModifierTakeDamageWatchSpawnEntity	app/sdk/modifiers/modifierTakeDamageWatchSpawnRandomBattlePet.coffee
ModifierTakeDamageWatchSpawnRandomHaunt	ModifierTakeDamageWatchSpawnEntity	app/sdk/modifiers/modifierTakeDamageWatchSpawnRandomHaunt.coffee
ModifierTakeDamageWatchSpawnRandomToken	ModifierTakeDamageWatchSpawnEntity	app/sdk/modifiers/modifierTakeDamageWatchSpawnRandomToken.coffee
ModifierTakeDamageWatchSpawnShadowCreep	ModifierTakeDamageWatch	app/sdk/modifiers/modifierTakeDamageWatchSpawnShadowCreep.coffee
ModifierTakeDamageWatchSpawnWraithlings	ModifierTakeDamageWatch	app/sdk/modifiers/modifierTakeDamageWatchSpawnWraithlings.coffee
ModifierTakesDoubleDamage	Modifier	app/sdk/modifiers/modifierTakesDoubleDamage.coffee
ModifierTamedBattlePet	Modifier	app/sdk/modifiers/modifierTamedBattlePet.coffee
ModifierToggleStructure	Modifier	app/sdk/modifiers/modifierToggleStructure.coffee
ModifierToken	Modifier	app/sdk/modifiers/modifierToken.coffee
ModifierTokenCreator	Modifier	app/sdk/modifiers/modifierTokenCreator.coffee
ModifierTranscendance	Modifier	app/sdk/modifiers/modifierTranscendance.coffee
ModifierTransformed	Modifier	app/sdk/modifiers/modifierTransformed.coffee
ModifierUnseven	ModifierDyingWish	app/sdk/modifiers/modifierUnseven.coffee
ModifierUntargetable	Modifier	app/sdk/modifiers/modifierUntargetable.coffee
ModifierWall	Modifier	app/sdk/modifiers/modifierWall.coffee
ModifierWhenAttackedDestroyThis	Modifier	app/sdk/modifiers/modifierWhenAttackedDestroyThis.coffee
ModifierWildTahr	ModifierEnemyAttackWatch	app/sdk/modifiers/modifierWildTahr.coffee
ModifierWraithlingFury	Modifier	app/sdk/modifiers/modifierWraithlingFury.coffee
Player	SDKObject	app/sdk/player.coffee
PlayerModiferCanSummonAnywhere	PlayerModifier	app/sdk/playerModifiers/playerModiferCanSummonAnywhere.coffee
PlayerModifier	Modifier	app/sdk/playerModifiers/playerModifier.coffee
PlayerModifierAncestralPact	PlayerModifier	app/sdk/playerModifiers/playerModifierAncestralPact.coffee
PlayerModifierBattlePetManager	PlayerModifier	app/sdk/playerModifiers/playerModifierBattlePetManager.coffee
PlayerModifierCannotReplace	PlayerModifier	app/sdk/playerModifiers/playerModifierCannotReplace.coffee
PlayerModifierCardDrawModifier	PlayerModifier	app/sdk/playerModifiers/playerModifierCardDrawModifier.coffee
PlayerModifierChangeSignatureCard	PlayerModifier	app/sdk/playerModifiers/playerModifierChangeSignatureCard.coffee
PlayerModifierDamageNextUnitPlayedFromHand	PlayerModifier	app/sdk/playerModifiers/playerModifierDamageNextUnitPlayedFromHand.coffee
PlayerModifierEmblem	PlayerModifier	app/sdk/playerModifiers/playerModifierEmblem.coffee
PlayerModifierEmblemEndTurnWatch	PlayerModifierEmblem	app/sdk/playerModifiers/playerModifierEmblemEndTurnWatch.coffee
PlayerModifierEmblemEndTurnWatchLyonarSmallMinionQuest	PlayerModifierEmblemEndTurnWatch	app/sdk/playerModifiers/playerModifierEmblemEndTurnWatchLyonarSmallMinionQuest.coffee
PlayerModifierEmblemGainMinionOrLoseControlWatch	PlayerModifierEmblem	app/sdk/playerModifiers/playerModifierEmblemGainMinionOrLoseControlWatch.coffee
PlayerModifierEmblemSituationalVetQuestCelerity	PlayerModifierEmblem	app/sdk/playerModifiers/playerModifierEmblemSituationalVetQuestCelerity.coffee
PlayerModifierEmblemSituationalVetQuestFlying	PlayerModifierEmblem	app/sdk/playerModifiers/playerModifierEmblemSituationalVetQuestFlying.coffee
PlayerModifierEmblemSituationalVetQuestFrenzy	PlayerModifierEmblem	app/sdk/playerModifiers/playerModifierEmblemSituationalVetQuestFrenzy.coffee
PlayerModifierEmblemSummonWatch	PlayerModifierEmblem	app/sdk/playerModifiers/playerModifierEmblemSummonWatch.coffee
PlayerModifierEmblemSummonWatchAbyssUndyingQuest	PlayerModifierEmblemGainMinionOrLoseControlWatch	app/sdk/playerModifiers/playerModifierEmblemSummonWatchAbyssUndyingQuest.coffee
PlayerModifierEmblemSummonWatchFromHandMagmarBuffQuest	PlayerModifierEmblemSummonWatch	app/sdk/playerModifiers/playerModifierEmblemSummonWatchFromHandMagmarBuffQuest.coffee
PlayerModifierEmblemSummonWatchSingletonQuest	PlayerModifierEmblemGainMinionOrLoseControlWatch	app/sdk/playerModifiers/playerModifierEmblemSummonWatchSingletonQuest.coffee
PlayerModifierEmblemSummonWatchSonghaiMeltdownQuest	PlayerModifierEmblemSummonWatch	app/sdk/playerModifiers/playerModifierEmblemSummonWatchSonghaiMeltdownQuest.coffee
PlayerModifierEmblemSummonWatchVanarTokenQuest	PlayerModifierEmblemGainMinionOrLoseControlWatch	app/sdk/playerModifiers/playerModifierEmblemSummonWatchVanarTokenQuest.coffee
PlayerModifierEndTurnRespawnEntityAnywhere	PlayerModifier	app/sdk/playerModifiers/playerModifierEndTurnRespawnEntityAnywhere.coffee
PlayerModifierEndTurnRespawnEntityWithBuff	PlayerModifier	app/sdk/playerModifiers/playerModifierEndTurnRespawnEntityWithBuff.coffee
PlayerModifierEndTurnWatchRevertBBS	PlayerModifier	app/sdk/playerModifiers/playerModifierEndTurnWatchRevertBBS.coffee
PlayerModifierFlashReincarnation	PlayerModifierManaModifier	app/sdk/playerModifiers/playerModifierFlashReincarnation.coffee
PlayerModifierFriendlyAttackWatch	PlayerModifier	app/sdk/playerModifiers/playerModifierFriendlyAttackWatch.coffee
PlayerModifierManaModifier	PlayerModifier	app/sdk/playerModifiers/playerModifierManaModifier.coffee
PlayerModifierManaModifierNextCard	PlayerModifierManaModifier	app/sdk/playerModifiers/playerModifierManaModifierNextCard.coffee
PlayerModifierManaModifierOncePerTurn	PlayerModifierManaModifier	app/sdk/playerModifiers/playerModifierManaModifierOncePerTurn.coffee
PlayerModifierManaModifierSingleUse	PlayerModifierManaModifier	app/sdk/playerModifiers/playerModifierManaModifierSingleUse.coffee
PlayerModifierMechazorBuildProgress	PlayerModifier	app/sdk/playerModifiers/playerModifierMechazorBuildProgress.coffee
PlayerModifierMechazorSummoned	PlayerModifier	app/sdk/playerModifiers/playerModifierMechazorSummoned.coffee
PlayerModifierMyDeathwatchDrawCard	PlayerModifier	app/sdk/playerModifiers/playerModifierMyDeathwatchDrawCard.coffee
PlayerModifierOpponentSummonWatch	PlayerModifier	app/sdk/playerModifiers/playerModifierOpponentSummonWatch.coffee
PlayerModifierOpponentSummonWatchSwapGeneral	PlayerModifierOpponentSummonWatch	app/sdk/playerModifiers/playerModifierOpponentSummonWatchSwapGeneral.coffee
PlayerModifierPreventSpellDamage	PlayerModifier	app/sdk/playerModifiers/playerModifierPreventSpellDamage.coffee
PlayerModifierReplaceCardModifier	PlayerModifier	app/sdk/playerModifiers/playerModifierReplaceCardModifier.coffee
PlayerModifierSignatureCardAlwaysReady	PlayerModifier	app/sdk/playerModifiers/playerModifierSignatureCardAlwaysReady.coffee
PlayerModifierSpellDamageModifier	PlayerModifier	app/sdk/playerModifiers/playerModifierSpellDamageModifier.coffee
PlayerModifierSpellWatch	PlayerModifier	app/sdk/playerModifiers/playerModifierSpellWatch.coffee
PlayerModifierSpellWatchHollowVortex	PlayerModifierSpellWatch	app/sdk/playerModifiers/playerModifierSpellWatchHollowVortex.coffee
PlayerModifierSpellWatchSpawnNeutralEntity	PlayerModifierSpellWatch	app/sdk/playerModifiers/playerModifierSpellWatchSpawnNeutralEntity.coffee
PlayerModifierSummonWatch	PlayerModifier	app/sdk/playerModifiers/playerModifierSummonWatch.coffee
PlayerModifierSummonWatchApplyModifiers	PlayerModifierSummonWatch	app/sdk/playerModifiers/playerModifierSummonWatchApplyModifiers.coffee
PlayerModifierSummonWatchFromActionBar	PlayerModifierSummonWatch	app/sdk/playerModifiers/playerModifierSummonWatchFromActionBar.coffee
PlayerModifierSummonWatchIfFlyingDrawFlyingMinion	PlayerModifierSummonWatchFromActionBar	app/sdk/playerModifiers/playerModifierSummonWatchIfFlyingDrawFlyingMinion.coffee
PlayerModifierTeamAlwaysBackstabbed	PlayerModifier	app/sdk/playerModifiers/playerModifierTeamAlwaysBackstabbed.coffee
QuestAlternateDealDamage	Quest	app/sdk/quests/questAlternateDealDamage.coffee
QuestAlternateDestroyUnits	Quest	app/sdk/quests/questAlternateDestroyUnits.coffee
QuestAnniversary2017	Quest	app/sdk/quests/questAnniversary2017.coffee
QuestBeginner	Quest	app/sdk/quests/questBeginner.coffee
QuestBeginnerCompleteSoloChallenges	QuestBeginner	app/sdk/quests/questBeginnerCompleteSoloChallenges.coffee
QuestBeginnerFactionLevel	QuestBeginner	app/sdk/quests/questBeginnerFactionLevel.coffee
QuestBeginnerPlayOneQuickMatch	QuestBeginner	app/sdk/quests/questBeginnerPlayOneQuickMatch.coffee
QuestBeginnerPlayPracticeGames	QuestBeginner	app/sdk/quests/questBeginnerPlayPracticeGames.coffee
QuestBeginnerWinFourPracticeGames	QuestBeginner	app/sdk/quests/questBeginnerWinFourPracticeGames.coffee
QuestBeginnerWinOneSeasonGame	QuestBeginner	app/sdk/quests/questBeginnerWinOneSeasonGame.coffee
QuestBeginnerWinPracticeGames	QuestBeginner	app/sdk/quests/questBeginnerWinPracticeGames.coffee
QuestBeginnerWinThreeQuickMatches	QuestBeginner	app/sdk/quests/questBeginnerWinThreeQuickMatches.coffee
QuestBeginnerWinThreeRankedMatches	QuestBeginner	app/sdk/quests/questBeginnerWinThreeRankedMatches.coffee
QuestBeginnerWinTwoPracticeGames	QuestBeginner	app/sdk/quests/questBeginnerWinTwoPracticeGames.coffee
QuestCatchUp	Quest	app/sdk/quests/questCatchUp.coffee
QuestFrostfire2016	Quest	app/sdk/quests/questFrostfire2016.coffee
QuestFrostfire2017	Quest	app/sdk/quests/questFrostfire2017.coffee
QuestGameGoal	Quest	app/sdk/quests/questGameGoal.coffee
QuestLegacyLaunch	Quest	app/sdk/quests/questLegacyLaunch.coffee
QuestParticipationWithFaction	Quest	app/sdk/quests/questParticipationWithFaction.coffee
QuestSeasonal2017April	Quest	app/sdk/quests/questSeasonal2017April.coffee
QuestSeasonal2017February	Quest	app/sdk/quests/questSeasonal2017February.coffee
QuestSeasonal2017March	Quest	app/sdk/quests/questSeasonal2017March.coffee
QuestSeasonal2017May	Quest	app/sdk/quests/questSeasonal2017May.coffee
QuestSeasonal2017October	Quest	app/sdk/quests/questSeasonal2017October.coffee
QuestSeasonal2018February	Quest	app/sdk/quests/questSeasonal2018February.coffee
QuestWinWithFaction	Quest	app/sdk/quests/questWinWithFaction.coffee
Spell	Card	app/sdk/spells/spell.coffee
SpellAbhorrentUnbirth	SpellSpawnEntity	app/sdk/spells/spellAbhorrentUnbirth.coffee
SpellAbyssalScar	SpellApplyModifiers	app/sdk/spells/spellAbyssalScar.coffee
SpellActivateFriendlyShadowCreep	Spell	app/sdk/spells/spellActivateFriendlyShadowCreep.coffee
SpellAfterblaze	SpellApplyModifiers	app/sdk/spells/spellAfterblaze.coffee
SpellAlteredBeast	SpellAspectBase	app/sdk/spells/spellAlteredBeast.coffee
SpellAmbush	SpellSpawnEntity	app/sdk/spells/spellAmbush.coffee
SpellAncestralDivination	Spell	app/sdk/spells/spellAncestralDivination.coffee
SpellApplyEntityToBoard	Spell	app/sdk/spells/spellApplyEntityToBoard.coffee
SpellApplyModifiers	Spell	app/sdk/spells/spellApplyModifiers.coffee
SpellApplyModifiersSummonTile	SpellApplyModifiers	app/sdk/spells/spellApplyModifiersSummonTile.coffee
SpellApplyModifiersToDamagedMinion	SpellApplyModifiers	app/sdk/spells/spellApplyModifiersToDamagedMinion.coffee
SpellApplyModifiersToExhaustedMinion	SpellApplyModifiers	app/sdk/spells/spellApplyModifiersToExhaustedMinion.coffee
SpellApplyModifiersToGeneral	Spell	app/sdk/spells/spellApplyModifiersToGeneral.coffee
SpellApplyModifiersToGeneralAndNearbyAllies	SpellApplyModifiers	app/sdk/spells/spellApplyModifiersToGeneralAndNearbyAllies.coffee
SpellApplyModifiersToUndamagedMinion	SpellApplyModifiers	app/sdk/spells/spellApplyModifiersToUndamagedMinion.coffee
SpellApplyModifiersToUnitAndGeneral	SpellApplyModifiers	app/sdk/spells/spellApplyModifiersToUnitAndGeneral.coffee
SpellApplyModifiersToUnitsInHand	Spell	app/sdk/spells/spellApplyModifiersToUnitsInHand.coffee
SpellApplyPlayerModifiers	SpellApplyModifiers	app/sdk/spells/spellApplyPlayerModifiers.coffee
SpellAspectBase	SpellRemoveAndReplaceEntity	app/sdk/spells/spellAspectBase.coffee
SpellAspectOfTheDrake	SpellAspectBase	app/sdk/spells/spellAspectOfTheDrake.coffee
SpellAspectOfTheMountains	SpellAspectBase	app/sdk/spells/spellAspectOfTheMountains.coffee
SpellAssassinationProtocol	SpellRefreshExhaustion	app/sdk/spells/spellAssassinationProtocol.coffee
SpellAstralFlood	Spell	app/sdk/spells/spellAstralFlood.coffee
SpellAurorasTears	Spell	app/sdk/spells/spellAurorasTears.coffee
SpellAvalanche	SpellStunAndDamage	app/sdk/spells/spellAvalanche.coffee
SpellHugToDeath	SpellRemoveAndReplaceEntity	app/sdk/spells/spellBamboozle.coffee
SpellBetrayal	Spell	app/sdk/spells/spellBetrayal.coffee
SpellBloodRage	SpellApplyModifiers	app/sdk/spells/spellBloodRage.coffee
SpellBoneSwarm	Spell	app/sdk/spells/spellBoneSwarm.coffee
SpellBounceToActionbarApplyModifiers	SpellApplyModifiers	app/sdk/spells/spellBounceToActionBarApplyModifiers.coffee
SpellBounceToActionBarSpawnEntity	SpellSpawnEntity	app/sdk/spells/spellBounceToActionBarSpawnEntity.coffee
SpellBounceToActionbar	Spell	app/sdk/spells/spellBounceToActionbar.coffee
SpellBreathOfTheUnborn	Spell	app/sdk/spells/spellBreathOfTheUnborn.coffee
SpellBuffAttributeByOtherAttribute	Spell	app/sdk/spells/spellBuffAttributeByOtherAttribute.coffee
SpellChargeIntoBattle	SpellApplyModifiers	app/sdk/spells/spellChargeIntoBattle.coffee
SpellChokingShadows	Spell	app/sdk/spells/spellChokingShadows.coffee
SpellChromaticCold	SpellSilence	app/sdk/spells/spellChromaticCold.coffee
SpellChrysalisBloom	SpellSpawnEntity	app/sdk/spells/spellChrysalisBloom.coffee
SpellCircleOfDesiccation	SpellKillTarget	app/sdk/spells/spellCircleOfDesiccation.coffee
SpellCloneSourceEntity	SpellApplyEntityToBoard	app/sdk/spells/spellCloneSourceEntity.coffee
SpellCloneSourceEntityNearbyGeneral	SpellCloneSourceEntity	app/sdk/spells/spellCloneSourceEntityNearbyGeneral.coffee
SpellCloneTargetEntity	SpellRemoveAndReplaceEntity	app/sdk/spells/spellCloneTargetEntity.coffee
SpellConsumingRebirth	SpellKillTarget	app/sdk/spells/spellConsumingRebirth.coffee
SpellCopyMinionToHand	Spell	app/sdk/spells/spellCopyMinionToHand.coffee
SpellCorpseCombustion	SpellSpawnEntity	app/sdk/spells/spellCorpseCombustion.coffee
SpellCreepingFrost	Spell	app/sdk/spells/spellCreepingFrost.coffee
SpellCrimsonCoil	SpellDamage	app/sdk/spells/spellCrimsonCoil.coffee
SpellCryogenesis	SpellDamage	app/sdk/spells/spellCryogenesis.coffee
SpellCurseOfShadows	SpellKillTarget	app/sdk/spells/spellCurseOfShadows.coffee
SpellDamage	Spell	app/sdk/spells/spellDamage.coffee
SpellDamageAndApplyModifiers	SpellApplyModifiers	app/sdk/spells/spellDamageAndApplyModifiers.coffee
SpellDamageAndPutCardInHand	SpellDamage	app/sdk/spells/spellDamageAndPutCardInHand.coffee
SpellDamageAndSpawnEntitiesNearbyGeneral	SpellSpawnEntity	app/sdk/spells/spellDamageAndSpawnEntitiesNearbyGeneral.coffee
SpellDamageCenterColumn	SpellDamage	app/sdk/spells/spellDamageCenterColumn.coffee
SpellDamageEnemyGeneralBothDrawCard	SpellDamage	app/sdk/spells/spellDamageEnemyGeneralBothDrawCard.coffee
SpellDamageMinionAndGeneral	SpellDamage	app/sdk/spells/spellDamageMinionAndGeneral.coffee
SpellDamageNotKillMinion	Spell	app/sdk/spells/spellDamageNotKillMinion.coffee
SpellDamageOrHeal	Spell	app/sdk/spells/spellDamageOrHeal.coffee
SpellDamageOwnGeneral	SpellDamage	app/sdk/spells/spellDamageOwnGeneral.coffee
SpellDamageUnitAndGeneral	SpellDamage	app/sdk/spells/spellDamageUnitAndGeneral.coffee
SpellDarkSacrifice	Spell	app/sdk/spells/spellDarkSacrifice.coffee
SpellDarkSeed	SpellDamage	app/sdk/spells/spellDarkSeed.coffee
SpellDeathIncoming	Spell	app/sdk/spells/spellDeathIncoming.coffee
SpellDecimate	SpellKillTarget	app/sdk/spells/spellDecimate.coffee
SpellDejaVu	Spell	app/sdk/spells/spellDejaVu.coffee
SpellDinoParty	Spell	app/sdk/spells/spellDinoParty.coffee
SpellDoubleAttackAndHealth	Spell	app/sdk/spells/spellDoubleAttackAndHealth.coffee
SpellDoubleAttributeBuffs	Spell	app/sdk/spells/spellDoubleAttributeBuffs.coffee
SpellDrawArtifact	Spell	app/sdk/spells/spellDrawArtifact.coffee
SpellDrawCardEndOfTurn	Spell	app/sdk/spells/spellDrawCardEndOfTurn.coffee
SpellDrawCardsIfHaveFriendlyTiles	Spell	app/sdk/spells/spellDrawCardsIfHaveFriendlyTiles.coffee
SpellDropLift	Spell	app/sdk/spells/spellDropLift.coffee
SpellDunecasterFollowup	SpellApplyModifiers	app/sdk/spells/spellDunecasterFollowup.coffee
SpellDuplicator	Spell	app/sdk/spells/spellDuplicator.coffee
SpellEchoingShriek	SpellAspectBase	app/sdk/spells/spellEchoingShriek.coffee
SpellEffulgentInfusion	SpellApplyModifiers	app/sdk/spells/spellEffulgentInfusion.coffee
SpellEggGrenade	SpellKillTarget	app/sdk/spells/spellEggGrenade.coffee
SpellEggMorph	SpellApplyEntityToBoard	app/sdk/spells/spellEggMorph.coffee
SpellEmbryoticInsight	Spell	app/sdk/spells/spellEmbryoticInsight.coffee
SpellEnslave	Spell	app/sdk/spells/spellEnslave.coffee
SpellEntanglingShadows	SpellSpawnEntity	app/sdk/spells/spellEntanglingShadows.coffee
SpellEquipBossArtifacts	Spell	app/sdk/spells/spellEquipBossArtifacts.coffee
SpellEquipVetArtifacts	Spell	app/sdk/spells/spellEquipVetArtifacts.coffee
SpellEssenceSculpt	Spell	app/sdk/spells/spellEssenceSculpt.coffee
SpellEvilXerox	SpellSpawnEntity	app/sdk/spells/spellEvilXerox.coffee
SpellFightingSpirit	SpellApplyModifiers	app/sdk/spells/spellFightingSpirit.coffee
SpellFillHandFromOpponentsDeck	Spell	app/sdk/spells/spellFillHandFromOpponentsDeck.coffee
SpellFirestormOfAgony	Spell	app/sdk/spells/spellFirestormOfAgony.coffee
SpellFlamingStampede	SpellDamage	app/sdk/spells/spellFlamingStampede.coffee
SpellFollowupActivateBattlePet	Spell	app/sdk/spells/spellFollowupActivateBattlePet.coffee
SpellFollowupDamage	Spell	app/sdk/spells/spellFollowupDamage.coffee
SpellFollowupFight	Spell	app/sdk/spells/spellFollowupFight.coffee
SpellFollowupHeal	Spell	app/sdk/spells/spellFollowupHeal.coffee
SpellFollowupHollowGroveKeeper	SpellKillTarget	app/sdk/spells/spellFollowupHollowGroveKeeper.coffee
SpellFollowupKeeper	SpellSpawnEntity	app/sdk/spells/spellFollowupKeeper.coffee
SpellFollowupKillTarget	Spell	app/sdk/spells/spellFollowupKillTarget.coffee
SpellFollowupKillTargetByAttack	SpellFollowupKillTarget	app/sdk/spells/spellFollowupKillTargetByAttack.coffee
SpellFollowupRandomTeleport	Spell	app/sdk/spells/spellFollowupRandomTeleport.coffee
SpellFollowupSpawnEntityFromDeck	SpellSpawnEntity	app/sdk/spells/spellFollowupSpawnEntityFromDeck.coffee
SpellFollowupSwapPositions	Spell	app/sdk/spells/spellFollowupSwapPositions.coffee
SpellFollowupTeleport	Spell	app/sdk/spells/spellFollowupTeleport.coffee
SpellFollowupTeleportInFrontOfAnyGeneral	SpellFollowupTeleport	app/sdk/spells/spellFollowupTeleportInFrontOfAnyGeneral.coffee
SpellFollowupTeleportMyGeneral	SpellFollowupTeleport	app/sdk/spells/spellFollowupTeleportMyGeneral.coffee
SpellFollowupTeleportMyGeneralBehindEnemy	SpellFollowupTeleportMyGeneral	app/sdk/spells/spellFollowupTeleportMyGeneralBehindEnemy.coffee
SpellFollowupTeleportNearMyGeneral	SpellFollowupTeleport	app/sdk/spells/spellFollowupTeleportNearMyGeneral.coffee
SpellFollowupTeleportToFriendlyCreep	SpellFollowupTeleport	app/sdk/spells/spellFollowupTeleportToFriendlyCreep.coffee
SpellFollowupTeleportToMe	SpellFollowupTeleport	app/sdk/spells/spellFollowupTeleportToMe.coffee
SpellForgeArtifact	Spell	app/sdk/spells/spellForgeArtifact.coffee
SpellFortifiedAssault	SpellDamage	app/sdk/spells/spellFortifiedAssault.coffee
SpellFountainOfYouth	Spell	app/sdk/spells/spellFountainOfYouth.coffee
SpellFriendlyJux	Spell	app/sdk/spells/spellFriendlyJux.coffee
SpellFrostburn	SpellDamage	app/sdk/spells/spellFrostburn.coffee
SpellFuriousLings	SpellShadowspawn	app/sdk/spells/spellFuriousLings.coffee
SpellGodMulligan	Spell	app/sdk/spells/spellGodMulligan.coffee
SpellGotatsu	SpellDamage	app/sdk/spells/spellGotatsu.coffee
SpellHatchAnEgg	Spell	app/sdk/spells/spellHatchAnEgg.coffee
SpellHeal	Spell	app/sdk/spells/spellHeal.coffee
SpellHealGeneralForEachFriendlyMinion	SpellHealYourGeneral	app/sdk/spells/spellHealGeneralForEachFriendlyMinion.coffee
SpellHealToFull	Spell	app/sdk/spells/spellHealToFull.coffee
SpellHealYourGeneral	SpellHeal	app/sdk/spells/spellHealYourGeneral.coffee
SpellHeavensEclipse	Spell	app/sdk/spells/spellHeavensEclipse.coffee
SpellHolyImmolation	Spell	app/sdk/spells/spellHolyImmolation.coffee
SpellHomeostaticRebuke	Spell	app/sdk/spells/spellHomeostaticRebuke.coffee
SpellIllusoryIce	Spell	app/sdk/spells/spellIllusoryIce.coffee
SpellInfiniteHowlers	SpellSpawnEntity	app/sdk/spells/spellInfiniteHowlers.coffee
SpellInklingSurge	SpellSpawnEntity	app/sdk/spells/spellInklingSurge.coffee
SpellInnerFocus	SpellRefreshExhaustion	app/sdk/spells/spellInnerFocus.coffee
SpellIntensify	Spell	app/sdk/spells/spellIntensify.coffee
SpellIntensifyDealDamage	SpellIntensify	app/sdk/spells/spellIntensifyDealDamage.coffee
SpellIntensifyHealMyGeneral	SpellIntensify	app/sdk/spells/spellIntensifyHealMyGeneral.coffee
SpellIntensifyIncreasingDominance	SpellIntensify	app/sdk/spells/spellIntensifyIncreasingDominance.coffee
SpellIntensifyShadowBlossom	SpellIntensify	app/sdk/spells/spellIntensifyShadowBlossom.coffee
SpellIntensifySpawnEntitiesNearGeneral	SpellIntensify	app/sdk/spells/spellIntensifySpawnEntitiesNearGeneral.coffee
SpellIntensifyTeleportOwnSide	SpellIntensify	app/sdk/spells/spellIntensifyTeleportOwnSide.coffee
SpellJoseki	Spell	app/sdk/spells/spellJoseki.coffee
SpellJuxtaposition	Spell	app/sdk/spells/spellJuxtaposition.coffee
SpellKillDamagedMinion	SpellKillTarget	app/sdk/spells/spellKillDamagedMinion.coffee
SpellKillEnemyOnFriendlyCreep	SpellKillTarget	app/sdk/spells/spellKillEnemyOnFriendlyCreep.coffee
SpellKillRandomTarget	Spell	app/sdk/spells/spellKillRandomTarget.coffee
SpellKillTarget	Spell	app/sdk/spells/spellKillTarget.coffee
SpellKillTargetSpawnEntity	SpellKillTarget	app/sdk/spells/spellKillTargetSpawnEntity.coffee
SpellKillTargetWithModifierRanged	SpellKillTarget	app/sdk/spells/spellKillTargetWithModifierRanged.coffee
SpellKillTargetWithModifierStunned	SpellKillTarget	app/sdk/spells/spellKillTargetWithModifierStunned.coffee
SpellKillingEdge	SpellApplyModifiers	app/sdk/spells/spellKillingEdge.coffee
SpellKineticSurge	SpellApplyPlayerModifiers	app/sdk/spells/spellKineticSurge.coffee
SpellKneel	Spell	app/sdk/spells/spellKneel.coffee
SpellKoanOfHorns	Spell	app/sdk/spells/spellKoanOfHorns.coffee
SpellLaceratingFrost	Spell	app/sdk/spells/spellLaceratingFrost.coffee
SpellLavaLance	SpellDamage	app/sdk/spells/spellLavaLance.coffee
SpellLavastorm	SpellKillTarget	app/sdk/spells/spellLavastorm.coffee
SpellLifeDrain	SpellKillTarget	app/sdk/spells/spellLifeDrain.coffee
SpellLifeSurge	SpellDamage	app/sdk/spells/spellLifeSurge.coffee
SpellLightningBlitz	SpellApplyModifiers	app/sdk/spells/spellLightningBlitz.coffee
SpellLostInTheDesert	Spell	app/sdk/spells/spellLostInTheDesert.coffee
SpellLucentBeam	SpellDamage	app/sdk/spells/spellLucentBeam.coffee
SpellLurkingFear	Spell	app/sdk/spells/spellLurkingFear.coffee
SpellMarchOfTheBrontos	Spell	app/sdk/spells/spellMarchOfTheBrontos.coffee
SpellMartyrdom	SpellKillTarget	app/sdk/spells/spellMartyrdom.coffee
SpellMassMojo	Spell	app/sdk/spells/spellMassMojo.coffee
SpellMetalworking	Spell	app/sdk/spells/spellMetalworking.coffee
SpellMightOfVespyr	SpellApplyModifiers	app/sdk/spells/spellMightOfVespyr.coffee
SpellMindControlByAttackValue	SpellEnslave	app/sdk/spells/spellMindControlByAttackValue.coffee
SpellMindSteal	SpellSpawnEntity	app/sdk/spells/spellMindSteal.coffee
SpellMirage	SpellApplyEntityToBoard	app/sdk/spells/spellMirage.coffee
SpellMirrorMeld	SpellApplyEntityToBoard	app/sdk/spells/spellMirrorMeld.coffee
SpellMistWalking	Spell	app/sdk/spells/spellMistWalking.coffee
SpellMoldingEarth	SpellSpawnEntity	app/sdk/spells/spellMoldingEarth.coffee
SpellMoltenRebirth	SpellSpawnEntity	app/sdk/spells/spellMoltenRebirth.coffee
SpellNaturalSelection	SpellKillTarget	app/sdk/spells/spellNaturalSelection.coffee
SpellNaturesConfluence	SpellSpawnEntity	app/sdk/spells/spellNaturesConfluence.coffee
SpellNetherSummoning	SpellSpawnEntity	app/sdk/spells/spellNetherSummoning.coffee
SpellNeurolink	Spell	app/sdk/spells/spellNeurolink.coffee
SpellNoshRakSpell	Spell	app/sdk/spells/spellNoshRakSpell.coffee
SpellOnceMoreWithProvoke	SpellSpawnEntity	app/sdk/spells/spellOnceMoreWithProvoke.coffee
SpellOverwatch	Spell	app/sdk/spells/spellOverwatch.coffee
SpellPandaJail	SpellSpawnEntity	app/sdk/spells/spellPandaJail.coffee
SpellPermafrostShield	SpellApplyModifiers	app/sdk/spells/spellPermafrostShield.coffee
SpellPsychicConduit	SpellApplyModifiers	app/sdk/spells/spellPsychicConduit.coffee
SpellRally	Spell	app/sdk/spells/spellRally.coffee
SpellRashasCurse	Spell	app/sdk/spells/spellRashasCurse.coffee
SpellRashasCurseFollowup	SpellSpawnEntity	app/sdk/spells/spellRashasCurseFollowup.coffee
SpellRazorSkin	SpellApplyModifiers	app/sdk/spells/spellRazorSkin.coffee
SpellRefreshExhaustion	Spell	app/sdk/spells/spellRefreshExhaustion.coffee
SpellRefreshFriendlyRanged	SpellRefreshExhaustion	app/sdk/spells/spellRefreshFriendlyRanged.coffee
SpellReggplicate	SpellSpawnEntity	app/sdk/spells/spellReggplicate.coffee
SpellRemoveAndReplaceEntity	SpellApplyEntityToBoard	app/sdk/spells/spellRemoveAndReplaceEntity.coffee
SpellRemoveArtifacts	Spell	app/sdk/spells/spellRemoveArtifacts.coffee
SpellRemoveTarget	Spell	app/sdk/spells/spellRemoveTarget.coffee
SpellRemoveTargetSpawnEntity	SpellRemoveTarget	app/sdk/spells/spellRemoveTargetSpawnEntity.coffee
SpellRequireUnoccupiedFriendlyCreep	Spell	app/sdk/spells/spellRequireUnoccupiedFriendlyCreep.coffee
SpellResilience	Spell	app/sdk/spells/spellResilience.coffee
SpellRestoreMana	Spell	app/sdk/spells/spellRestoreMana.coffee
SpellRestoringLight	Spell	app/sdk/spells/spellRestoringLight.coffee
SpellRiddle	Spell	app/sdk/spells/spellRiddle.coffee
SpellRiteOfTheUndervault	Spell	app/sdk/spells/spellRiteOfTheUndervault.coffee
SpellSacrificeBBS	SpellKillTarget	app/sdk/spells/spellSacrificeBBS.coffee
SpellSaurianFinality	Spell	app/sdk/spells/spellSaurianFinality.coffee
SpellScionsSecondWish	Spell	app/sdk/spells/spellScionsSecondWish.coffee
SpellOverload	Spell	app/sdk/spells/spellSeekingEye.coffee
SpellSetHealthEqualToAttack	Spell	app/sdk/spells/spellSetHealthEqualToAttack.coffee
SpellShadowWaltz	SpellApplyModifiersToUnitsInHand	app/sdk/spells/spellShadowWaltz.coffee
SpellShadows	SpellSpawnEntity	app/sdk/spells/spellShadows.coffee
SpellShadowspawn	SpellSpawnEntity	app/sdk/spells/spellShadowspawn.coffee
SpellSilence	Spell	app/sdk/spells/spellSilence.coffee
SpellSilenceAndSpawnEntityNearby	SpellSpawnEntityRandomlyAroundTarget	app/sdk/spells/spellSilenceAndSpawnEntityNearby.coffee
SpellSkyBurial	SpellKillTarget	app/sdk/spells/spellSkyBurial.coffee
SpellSpawnEntitiesOnEdgeSpaces	SpellSpawnEntity	app/sdk/spells/spellSpawnEntitiesOnEdgeSpaces.coffee
SpellSpawnEntitiesOnGeneralsDiagonals	SpellSpawnEntity	app/sdk/spells/spellSpawnEntitiesOnGeneralsDiagonals.coffee
SpellSpawnEntity	SpellApplyEntityToBoard	app/sdk/spells/spellSpawnEntity.coffee
SpellSpawnEntityAndApplyPlayerModifiers	SpellSpawnEntity	app/sdk/spells/spellSpawnEntityAndApplyPlayerModifiers.coffee
SpellSpawnEntityInFrontOfGeneral	SpellSpawnEntity	app/sdk/spells/spellSpawnEntityInFrontOfGeneral.coffee
SpellSpawnEntityNearbyGeneral	SpellSpawnEntity	app/sdk/spells/spellSpawnEntityNearbyGeneral.coffee
SpellSpawnEntityOnShadowCreep	SpellSpawnEntity	app/sdk/spells/spellSpawnEntityOnShadowCreep.coffee
SpellSpawnEntityRandomlyAroundTarget	SpellSpawnEntity	app/sdk/spells/spellSpawnEntityRandomlyAroundTarget.coffee
SpellSpawnNeutralEntity	SpellSpawnEntity	app/sdk/spells/spellSpawnNeutralEntity.coffee
SpellSpawnTilesInCenterColumn	SpellSpawnEntity	app/sdk/spells/spellSpawnTilesInCenterColumn.coffee
SpellSpiralCounter	SpellDamage	app/sdk/spells/spellSpiralCounter.coffee
SpellSpiritAnimalBlessing	SpellRefreshExhaustion	app/sdk/spells/spellSpiritAnimalBlessing.coffee
SpellStarsFury	SpellSpawnEntity	app/sdk/spells/spellStarsFury.coffee
SpellStunAndDamage	SpellApplyModifiers	app/sdk/spells/spellStunAndDamage.coffee
SpellSummonDeadMinionOnHallowedGround	SpellSpawnEntity	app/sdk/spells/spellSummonDeadMinionOnHallowedGround.coffee
SpellSummonHighestCostMinion	SpellSpawnEntity	app/sdk/spells/spellSummonHighestCostMinion.coffee
SpellSummonHusks	SpellKillTarget	app/sdk/spells/spellSummonHusks.coffee
SpellSummoningStones	Spell	app/sdk/spells/spellSummoningStones.coffee
SpellSunstrike	Spell	app/sdk/spells/spellSunstrike.coffee
SpellSwapStats	Spell	app/sdk/spells/spellSwapStats.coffee
SpellSwordsBBS	Spell	app/sdk/spells/spellSwordsBBS.coffee
SpellRainOfSpikes	Spell	app/sdk/spells/spellTectonicSpikes.coffee
SpellTeleportGeneralBehindEnemy	Spell	app/sdk/spells/spellTeleportGeneralBehindEnemy.coffee
SpellTempTransform	SpellRemoveAndReplaceEntity	app/sdk/spells/spellTempTransform.coffee
SpellThoughtExchange	Spell	app/sdk/spells/spellThoughtExchange.coffee
SpellThunderbomb	SpellDamage	app/sdk/spells/spellThunderbomb.coffee
SpellTickleTendril	Spell	app/sdk/spells/spellTickleTendril.coffee
SpellTimeMaelstrom	SpellRefreshExhaustion	app/sdk/spells/spellTimeMaelstrom.coffee
SpellTogetherness	Spell	app/sdk/spells/spellTogetherness.coffee
SpellToothAndTrial	SpellSilence	app/sdk/spells/spellToothAndTrial.coffee
SpellTransformSameManaCost	Spell	app/sdk/spells/spellTransformSameManaCost.coffee
SpellTwinStrike	SpellDamage	app/sdk/spells/spellTwinStrike.coffee
SpellTwoForMe	Spell	app/sdk/spells/spellTwoForMe.coffee
SpellUpperHand	Spell	app/sdk/spells/spellUpperHand.coffee
SpellVaathsSpirit	SpellApplyModifiers	app/sdk/spells/spellVaathsSpirit.coffee
SpellVeilOfUnraveling	SpellDamage	app/sdk/spells/spellVeilOfUnraveling.coffee
SpellSoulclamp	Spell	app/sdk/spells/spellVellumscry.coffee
SpellVespyricCall	Spell	app/sdk/spells/spellVespyricCall.coffee
SpellVoidPulse	Spell	app/sdk/spells/spellVoidPulse.coffee
SpellVoidSteal	SpellApplyModifiers	app/sdk/spells/spellVoidSteal.coffee
SpellWailingOverdrive	SpellApplyModifiers	app/sdk/spells/spellWailingOverdrive.coffee
SpellWarbird	SpellDamage	app/sdk/spells/spellWarbird.coffee
SpellWhisperOfTheSands	Spell	app/sdk/spells/spellWhisperOfTheSands.coffee
SpellWindShroud	SpellSpawnEntity	app/sdk/spells/spellWindShroud.coffee
SpellWintersWake	SpellApplyModifiers	app/sdk/spells/spellWintersWake.coffee
SpellWraithstorm	SpellKillTargetSpawnEntity	app/sdk/spells/spellWraithstorm.coffee
SpellWrathOfGod	SpellKillTarget	app/sdk/spells/spellWrathOfGod.coffee
SpellYellRealLoud	SpellApplyModifiers	app/sdk/spells/spellYellRealLoud.coffee
SpellZodiacTriad	Spell	app/sdk/spells/spellZodiacTriad.coffee
Step	SDKObject	app/sdk/step.coffee
ValidatorApplyCardToBoard	Validator	app/sdk/validators/validatorApplyCardToBoard.coffee
ValidatorEntityAction	Validator	app/sdk/validators/validatorEntityAction.coffee
ValidatorExecuteExplicitAction	Validator	app/sdk/validators/validatorExecuteExplicitAction.coffee
ValidatorFollowup	Validator	app/sdk/validators/validatorFollowup.coffee
ValidatorPlayCard	Validator	app/sdk/validators/validatorPlayCard.coffee
ValidatorReplaceCardFromHand	Validator	app/sdk/validators/validatorReplaceCardFromHand.coffee
ValidatorScheduledForRemoval	Validator	app/sdk/validators/validatorScheduledForRemoval.coffee
ModifierAction	Action	app/view/helpers/modifierAction.coffee
ModifierActivatedAction	ModifierAction	app/view/helpers/modifierActivatedAction.coffee
ModifierDeactivatedAction	ModifierAction	app/view/helpers/modifierDeactivatedAction.coffee
ModifierTriggeredAction	ModifierAction	app/view/helpers/modifierTriggeredAction.coffee