card_id	fx_identifier	source
Cards.Artifact.AbyssianRelic	FX.Cards.Artifact.AbyssianRelic	app/sdk/cards/factory/wartech/neutral.coffee
Cards.Artifact.AdamantineClaws	FX.Cards.Artifact.AdamantineClaws	app/sdk/cards/factory/core/faction5.coffee
Cards.Artifact.AngryRebirthAmulet	FX.Cards.Artifact.HornOfTheForsaken	app/sdk/cards/factory/unity/faction4.coffee
Cards.Artifact.AnimusPlate	FX.Cards.Artifact.AnimusPlate	app/sdk/cards/factory/wartech/faction6.coffee
Cards.Artifact.AnkhFireNova	FX.Cards.Artifact.AnkhFireNova	app/sdk/cards/factory/core/faction3.coffee
Cards.Artifact.ArclyteRegalia	FX.Cards.Artifact.ArclyteRegalia	app/sdk/cards/factory/core/faction1.coffee
Cards.Artifact.BackstabGloves	FX.Cards.Artifact.EnergyAmulet	app/sdk/cards/factory/coreshatter/faction2.coffee
Cards.Artifact.CrescentSpear	FX.Cards.Artifact.CrescentSpear	app/sdk/cards/factory/shimzar/faction2.coffee
Cards.Artifact.DawnsEye	FX.Cards.Artifact.DawnsEye	app/sdk/cards/factory/shimzar/faction1.coffee
Cards.Artifact.EggArmor	FX.Cards.Artifact.OblivionSickle	app/sdk/cards/factory/coreshatter/faction5.coffee
Cards.Artifact.EnergyAmulet	FX.Cards.Artifact.EnergyAmulet	app/sdk/cards/factory/firstwatch/faction2.coffee
Cards.Artifact.EternalHeart	FX.Cards.Artifact.EternalHeart	app/sdk/cards/factory/firstwatch/faction5.coffee
Cards.Artifact.Frostbiter	FX.Cards.Artifact.Frostbiter	app/sdk/cards/factory/core/faction6.coffee
Cards.Artifact.FurorChakram	FX.Cards.Artifact.FurorChakram	app/sdk/cards/factory/wartech/faction4.coffee
Cards.Artifact.GhostAzalea	FX.Cards.Artifact.GhostAzalea	app/sdk/cards/factory/shimzar/faction4.coffee
Cards.Artifact.GoldVitriol	FX.Cards.Artifact.SunstoneBracers	app/sdk/cards/factory/unity/faction1.coffee
Cards.Artifact.GrowthBangle	FX.Cards.Artifact.SunstoneBracers	app/sdk/cards/factory/unity/faction5.coffee
Cards.Artifact.HaloBulwark	FX.Cards.Artifact.HaloBulwark	app/sdk/cards/factory/firstwatch/faction1.coffee
Cards.Artifact.HornOfTheForsaken	FX.Cards.Artifact.HornOfTheForsaken	app/sdk/cards/factory/core/faction4.coffee
Cards.Artifact.IndomitableWill	FX.Cards.Artifact.IndomitableWill	app/sdk/cards/factory/core/faction1.coffee
Cards.Artifact.IrisBarrier	FX.Cards.Artifact.IrisBarrier	app/sdk/cards/factory/wartech/faction3.coffee
Cards.Artifact.LyonarRelic	FX.Cards.Artifact.LyonarRelic	app/sdk/cards/factory/wartech/neutral.coffee
Cards.Artifact.MagmarRelic	FX.Cards.Artifact.MagmarRelic	app/sdk/cards/factory/wartech/neutral.coffee
Cards.Artifact.MaskOfBloodLeech	FX.Cards.Artifact.MaskOfBloodLeech	app/sdk/cards/factory/core/faction2.coffee
Cards.Artifact.MaskOfCelerity	FX.Cards.Artifact.MaskOfShadows	app/sdk/cards/factory/unity/faction2.coffee
Cards.Artifact.MaskOfShadows	FX.Cards.Artifact.MaskOfShadows	app/sdk/cards/factory/core/faction2.coffee
Cards.Artifact.MaskOfTranscendance	FX.Cards.Artifact.MaskOfTranscendance	app/sdk/cards/factory/core/faction2.coffee
Cards.Artifact.Mindlathe	FX.Cards.Artifact.Mindlathe	app/sdk/cards/factory/firstwatch/faction4.coffee
Cards.Artifact.MorinKhur	FX.Cards.Artifact.MorinKhur	app/sdk/cards/factory/shimzar/faction5.coffee
Cards.Artifact.NeutralRelic	FX.Cards.Artifact.NeutralRelic	app/sdk/cards/factory/wartech/neutral.coffee
Cards.Artifact.OblivionSickle	FX.Cards.Artifact.OblivionSickle	app/sdk/cards/factory/firstwatch/faction3.coffee
Cards.Artifact.OrnateHiogi	FX.Cards.Artifact.OrnateHiogi	app/sdk/cards/factory/wartech/faction2.coffee
Cards.Artifact.PoisonHexblade	FX.Cards.Artifact.PoisonHexblade	app/sdk/cards/factory/core/faction3.coffee
Cards.Artifact.PristineScale	FX.Cards.Artifact.PristineScale	app/sdk/cards/factory/core/faction5.coffee
Cards.Artifact.RageReactor	FX.Cards.Artifact.RageReactor	app/sdk/cards/factory/wartech/faction5.coffee
Cards.Artifact.RepairSword	FX.Cards.Artifact.Winterblade	app/sdk/cards/factory/coreshatter/faction3.coffee
Cards.Artifact.ShatteringHeart	FX.Cards.Artifact.Frostbiter	app/sdk/cards/factory/unity/faction6.coffee
Cards.Artifact.SnowChipper	FX.Cards.Artifact.OblivionSickle	app/sdk/cards/factory/coreshatter/faction6.coffee
Cards.Artifact.Snowpiercer	FX.Cards.Artifact.Snowpiercer	app/sdk/cards/factory/core/faction6.coffee
Cards.Artifact.SonghaiRelic	FX.Cards.Artifact.SonghaiRelic	app/sdk/cards/factory/wartech/neutral.coffee
Cards.Artifact.SoulGrimwar	FX.Cards.Artifact.SoulGrimwar	app/sdk/cards/factory/core/faction4.coffee
Cards.Artifact.SpectralBlade	FX.Cards.Artifact.SpectralBlade	app/sdk/cards/factory/core/faction4.coffee
Cards.Artifact.Spinecleaver	FX.Cards.Artifact.StaffOfYKir	app/sdk/cards/factory/shimzar/faction3.coffee
Cards.Artifact.StaffOfYKir	FX.Cards.Artifact.StaffOfYKir	app/sdk/cards/factory/core/faction3.coffee
Cards.Artifact.SunbondPavise	FX.Cards.Artifact.SunbondPavise	app/sdk/cards/factory/wartech/faction1.coffee
Cards.Artifact.SunstoneBracers	FX.Cards.Artifact.SunstoneBracers	app/sdk/cards/factory/core/faction1.coffee
Cards.Artifact.TheDredger	FX.Cards.Artifact.TheDredger	app/sdk/cards/factory/firstwatch/faction6.coffee
Cards.Artifact.Thunderclap	FX.Cards.Artifact.HornOfTheForsaken	app/sdk/cards/factory/unity/faction3.coffee
Cards.Artifact.TwinFang	FX.Cards.Artifact.TwinFang	app/sdk/cards/factory/core/faction5.coffee
Cards.Artifact.TwoHander	FX.Cards.Artifact.SunstoneBracers	app/sdk/cards/factory/coreshatter/faction1.coffee
Cards.Artifact.VanarRelic	FX.Cards.Artifact.VanarRelic	app/sdk/cards/factory/wartech/neutral.coffee
Cards.Artifact.VetruvianRelic	FX.Cards.Artifact.VetruvianRelic	app/sdk/cards/factory/wartech/neutral.coffee
Cards.Artifact.WhiteAsp	FX.Cards.Artifact.WhiteAsp	app/sdk/cards/factory/shimzar/faction6.coffee
Cards.Artifact.Winterblade	FX.Cards.Artifact.Winterblade	app/sdk/cards/factory/core/faction6.coffee
Cards.Artifact.WraithlingAmulet	FX.Cards.Artifact.Mindlathe	app/sdk/cards/factory/coreshatter/faction4.coffee
Cards.Boss.Boss1	FX.Cards.Faction5.Dreadnaught	app/sdk/cards/factory/misc/bosses.coffee
Cards.Boss.Boss10	FX.Cards.Neutral.WarTalon	app/sdk/cards/factory/misc/bosses.coffee
Cards.Boss.Boss11	FX.Cards.Neutral.EMP	app/sdk/cards/factory/misc/bosses.coffee
Cards.Boss.Boss12	FX.Cards.Neutral.ArchonSpellbinder	app/sdk/cards/factory/misc/bosses.coffee
Cards.Boss.Boss12Idol	FX.Cards.Neutral.Bastion	app/sdk/cards/factory/misc/bosses.coffee
Cards.Boss.Boss13	FX.Cards.Neutral.TheHighHand	app/sdk/cards/factory/misc/bosses.coffee
Cards.Boss.Boss14	FX.Cards.Faction4.BlackSolus	app/sdk/cards/factory/misc/bosses.coffee
Cards.Boss.Boss15	FX.Cards.Neutral.EXun	app/sdk/cards/factory/misc/bosses.coffee
Cards.Boss.Boss16	FX.Cards.Neutral.Chakkram	app/sdk/cards/factory/misc/bosses.coffee
Cards.Boss.Boss17	FX.Cards.Neutral.WhiteWidow	app/sdk/cards/factory/misc/bosses.coffee
Cards.Boss.Boss18	FX.Cards.Neutral.Serpenti	app/sdk/cards/factory/misc/bosses.coffee
Cards.Boss.Boss19	FX.Cards.Faction4.ArcaneDevourer	app/sdk/cards/factory/misc/bosses.coffee
Cards.Boss.Boss2	FX.Cards.Neutral.MirkbloodDevourer	app/sdk/cards/factory/misc/bosses.coffee
Cards.Boss.Boss20	FX.Cards.Neutral.FlameWing	app/sdk/cards/factory/misc/bosses.coffee
Cards.Boss.Boss21	FX.Cards.Faction4.AbyssalCrawler	app/sdk/cards/factory/misc/bosses.coffee
Cards.Boss.Boss22	FX.Cards.Faction1.ArclyteSentinel	app/sdk/cards/factory/misc/bosses.coffee
Cards.Boss.Boss23	FX.Cards.Faction5.PrimordialGazer	app/sdk/cards/factory/misc/bosses.coffee
Cards.Boss.Boss24	FX.Cards.Neutral.SwornAvenger	app/sdk/cards/factory/misc/bosses.coffee
Cards.Boss.Boss24Valiant	FX.Cards.Neutral.SwornDefender	app/sdk/cards/factory/misc/bosses.coffee
Cards.Boss.Boss25	FX.Cards.Neutral.QuartermasterGauj	app/sdk/cards/factory/misc/bosses.coffee
Cards.Boss.Boss26	FX.Cards.Neutral.BloodTaura	app/sdk/cards/factory/misc/bosses.coffee
Cards.Boss.Boss26Companion	FX.Cards.Faction1.RadiantDragoon	app/sdk/cards/factory/misc/bosses.coffee
Cards.Boss.Boss27	FX.Cards.Neutral.Tethermancer	app/sdk/cards/factory/misc/bosses.coffee
Cards.Boss.Boss28	FX.Cards.Faction5.EarthWalker	app/sdk/cards/factory/misc/bosses.coffee
Cards.Boss.Boss29	FX.Cards.Faction3.Pantheran	app/sdk/cards/factory/misc/bosses.coffee
Cards.Boss.Boss3	FX.Cards.Faction1.CaliberO	app/sdk/cards/factory/misc/bosses.coffee
Cards.Boss.Boss30	FX.Cards.Faction1.LysianBrawler	app/sdk/cards/factory/misc/bosses.coffee
Cards.Boss.Boss31	FX.Cards.Faction4.DeathKnell	app/sdk/cards/factory/misc/bosses.coffee
Cards.Boss.Boss31Haunt1	FX.Cards.Faction2.CelestialPhantom	app/sdk/cards/factory/misc/bosses.coffee
Cards.Boss.Boss31Haunt2	FX.Cards.Faction2.CelestialPhantom	app/sdk/cards/factory/misc/bosses.coffee
Cards.Boss.Boss31Haunt3	FX.Cards.Faction2.CelestialPhantom	app/sdk/cards/factory/misc/bosses.coffee
Cards.Boss.Boss31Treat1	FX.Cards.Faction2.OnyxBear	app/sdk/cards/factory/misc/bosses.coffee
Cards.Boss.Boss31Treat2	FX.Cards.Faction2.OnyxBear	app/sdk/cards/factory/misc/bosses.coffee
Cards.Boss.Boss31Treat3	FX.Cards.Faction2.OnyxBear	app/sdk/cards/factory/misc/bosses.coffee
Cards.Boss.Boss32	FX.Cards.Faction6.PrismaticGiant	app/sdk/cards/factory/misc/bosses.coffee
Cards.Boss.Boss32_2	FX.Cards.Neutral.Zyx	app/sdk/cards/factory/misc/bosses.coffee
Cards.Boss.Boss33	FX.Cards.Neutral.NightWatcher	app/sdk/cards/factory/misc/bosses.coffee
Cards.Boss.Boss33_1	FX.Cards.Neutral.NightWatcher	app/sdk/cards/factory/misc/bosses.coffee
Cards.Boss.Boss33_2	FX.Cards.Neutral.NightWatcher	app/sdk/cards/factory/misc/bosses.coffee
Cards.Boss.Boss33_3	FX.Cards.Neutral.NightWatcher	app/sdk/cards/factory/misc/bosses.coffee
Cards.Boss.Boss33_4	FX.Cards.Neutral.NightWatcher	app/sdk/cards/factory/misc/bosses.coffee
Cards.Boss.Boss34	FX.Cards.Faction2.JadeOgre	app/sdk/cards/factory/misc/bosses.coffee
Cards.Boss.Boss34_2	FX.Cards.Faction2.JadeOgre	app/sdk/cards/factory/misc/bosses.coffee
Cards.Boss.Boss35	FX.Cards.Neutral.Pandora	app/sdk/cards/factory/misc/bosses.coffee
Cards.Boss.Boss36	FX.Cards.Faction3.GrandmasterNoshRak	app/sdk/cards/factory/misc/bosses.coffee
Cards.Boss.Boss36_2	FX.Cards.Faction1.IroncliffeGuardian	app/sdk/cards/factory/misc/bosses.coffee
Cards.Boss.Boss36_3	FX.Cards.Faction3.BrazierDuskWind	app/sdk/cards/factory/misc/bosses.coffee
Cards.Boss.Boss37	FX.Cards.Faction2.CelestialPhantom	app/sdk/cards/factory/misc/bosses.coffee
Cards.Boss.Boss38	FX.Cards.Neutral.Grailmaster	app/sdk/cards/factory/misc/bosses.coffee
Cards.Boss.Boss4	FX.Cards.Neutral.Ironclad	app/sdk/cards/factory/misc/bosses.coffee
Cards.Boss.Boss5	FX.Cards.Faction2.GrandmasterZendo	app/sdk/cards/factory/misc/bosses.coffee
Cards.Boss.Boss6	FX.Cards.Neutral.Mechaz0rHelm	app/sdk/cards/factory/misc/bosses.coffee
Cards.Boss.Boss6Chassis	FX.Cards.Neutral.Mechaz0rChassis	app/sdk/cards/factory/misc/bosses.coffee
Cards.Boss.Boss6Helm	FX.Cards.Neutral.Mechaz0rHelm	app/sdk/cards/factory/misc/bosses.coffee
Cards.Boss.Boss6Prime	FX.Cards.Neutral.AlterRexx	app/sdk/cards/factory/misc/bosses.coffee
Cards.Boss.Boss6Sword	FX.Cards.Neutral.Mechaz0rSword	app/sdk/cards/factory/misc/bosses.coffee
Cards.Boss.Boss6Wings	FX.Cards.Neutral.Mechaz0rWings	app/sdk/cards/factory/misc/bosses.coffee
Cards.Boss.Boss7	FX.Cards.Faction1.CaliberO	app/sdk/cards/factory/misc/bosses.coffee
Cards.Boss.Boss8	FX.Cards.Neutral.NightWatcher	app/sdk/cards/factory/misc/bosses.coffee
Cards.Boss.Boss9	FX.Cards.Neutral.EXun	app/sdk/cards/factory/misc/bosses.coffee
Cards.Boss.Boss9Clone	FX.Cards.Neutral.EXun	app/sdk/cards/factory/misc/bosses.coffee
Cards.Boss.FrostfireImp	FX.Cards.Neutral.Zyx	app/sdk/cards/factory/misc/bosses.coffee
Cards.Boss.FrostfireSnowchaser	FX.Cards.Faction6.SnowElemental	app/sdk/cards/factory/misc/bosses.coffee
Cards.Boss.FrostfireTiger	FX.Cards.Neutral.SaberspineTiger	app/sdk/cards/factory/misc/bosses.coffee
Cards.Boss.QABoss3	FX.Cards.Faction1.CaliberO	app/sdk/cards/factory/misc/bosses.coffee
Cards.BossArtifact.Coal	FX.Cards.Artifact.PristineScale	app/sdk/cards/factory/misc/bosses.coffee
Cards.BossArtifact.CostReducer	FX.Cards.Artifact.SoulGrimwar	app/sdk/cards/factory/misc/bosses.coffee
Cards.BossArtifact.CycloneGenerator	FX.Cards.Artifact.IndomitableWill	app/sdk/cards/factory/misc/bosses.coffee
Cards.BossArtifact.FlyingBells	FX.Cards.Artifact.MaskOfShadows	app/sdk/cards/factory/misc/bosses.coffee
Cards.BossArtifact.FrostArmor	FX.Cards.Artifact.ArclyteRegalia	app/sdk/cards/factory/misc/bosses.coffee
Cards.BossArtifact.Snowball	FX.Cards.Artifact.EternalHeart	app/sdk/cards/factory/misc/bosses.coffee
Cards.BossSpell.AncientKnowledge	FX.Cards.Spell.AncientKnowledge	app/sdk/cards/factory/misc/bosses.coffee
Cards.BossSpell.EntanglingShadow	FX.Cards.Spell.EntanglingShadow	app/sdk/cards/factory/misc/bosses.coffee
Cards.BossSpell.EtherealWind	FX.Cards.Spell.EtherealWind	app/sdk/cards/factory/misc/bosses.coffee
Cards.BossSpell.HolidayGift	FX.Cards.Spell.AutarchsGifts	app/sdk/cards/factory/misc/bosses.coffee
Cards.BossSpell.LaceratingFrost	FX.Cards.Spell.LaceratingFrost	app/sdk/cards/factory/misc/bosses.coffee
Cards.BossSpell.LivingFlame	FX.Cards.Spell.LivingFlame	app/sdk/cards/factory/misc/bosses.coffee
Cards.BossSpell.MoldingEarth	FX.Cards.Spell.MoldingEarth	app/sdk/cards/factory/misc/bosses.coffee
Cards.BossSpell.RestoringLight	FX.Cards.Spell.RestoringLight	app/sdk/cards/factory/misc/bosses.coffee
Cards.Faction1.AlabasterTitan	FX.Cards.Neutral.BloodTaura	app/sdk/cards/factory/firstwatch/faction1.coffee
Cards.Faction1.AltGeneral	FX.Cards.Faction1.ZiranSunforge	app/sdk/cards/factory/core/faction1.coffee
Cards.Faction1.ArclyteSentinel	FX.Cards.Faction1.ArclyteSentinel	app/sdk/cards/factory/core/faction1.coffee
Cards.Faction1.Auroara	FX.Cards.Neutral.Tethermancer	app/sdk/cards/factory/firstwatch/faction1.coffee
Cards.Faction1.AzuriteLion	FX.Cards.Faction1.AzuriteLion	app/sdk/cards/factory/core/faction1.coffee
Cards.Faction1.CatapultGryphon	FX.Cards.Neutral.WingsOfParadise	app/sdk/cards/factory/coreshatter/faction1.coffee
Cards.Faction1.DecoratedEnlistee	FX.Cards.Neutral.Chakkram	app/sdk/cards/factory/wartech/faction1.coffee
Cards.Faction1.ElyxStormblade	FX.Cards.Faction1.ElyxStormblade	app/sdk/cards/factory/core/faction1.coffee
Cards.Faction1.Excelsious	FX.Cards.Faction1.IroncliffeGuardian	app/sdk/cards/factory/bloodstorm/faction1.coffee
Cards.Faction1.Fiz	FX.Cards.Faction1.AzuriteLion	app/sdk/cards/factory/shimzar/faction1.coffee
Cards.Faction1.FriendFighter	FX.Cards.Faction1.RadiantDragoon	app/sdk/cards/factory/coreshatter/faction1.coffee
Cards.Faction1.Friendsguard	FX.Cards.Neutral.GoldenJusticar	app/sdk/cards/factory/coreshatter/faction1.coffee
Cards.Faction1.General	FX.Cards.Faction1.General	app/sdk/cards/factory/core/faction1.coffee
Cards.Faction1.GrandmasterZir	FX.Cards.Faction1.GrandmasterZir	app/sdk/cards/factory/core/faction1.coffee
Cards.Faction1.Invincibuddy	FX.Cards.Neutral.BlisteringSkorn	app/sdk/cards/factory/coreshatter/faction1.coffee
Cards.Faction1.IroncliffeGuardian	FX.Cards.Faction1.IroncliffeGuardian	app/sdk/cards/factory/core/faction1.coffee
Cards.Faction1.IroncliffeMonument	FX.Cards.Neutral.Bastion	app/sdk/cards/factory/wartech/faction1.coffee
Cards.Faction1.KingsGuard	FX.Cards.Faction1.SilverguardSquire	app/sdk/cards/factory/core/faction1.coffee
Cards.Faction1.Lightchaser	FX.Cards.Faction1.Lightchaser	app/sdk/cards/factory/core/faction1.coffee
Cards.Faction1.LysianBrawler	FX.Cards.Faction1.LysianBrawler	app/sdk/cards/factory/core/faction1.coffee
Cards.Faction1.MonumentBuilding	FX.Cards.Neutral.Bastion	app/sdk/cards/factory/wartech/faction1.coffee
Cards.Faction1.Oakenheart	FX.Cards.Neutral.DaggerKiri	app/sdk/cards/factory/wartech/faction1.coffee
Cards.Faction1.OneManArmy	FX.Cards.Faction1.SilverguardSquire	app/sdk/cards/factory/coreshatter/faction1.coffee
Cards.Faction1.Peacekeeper	FX.Cards.Neutral.GolemVanquisher	app/sdk/cards/factory/unity/faction1.coffee
Cards.Faction1.Prominence	FX.Cards.Neutral.GoldenJusticar	app/sdk/cards/factory/wartech/faction1.coffee
Cards.Faction1.PurebladeEnforcer	FX.Cards.Neutral.CrimsonOculus	app/sdk/cards/factory/firstwatch/faction1.coffee
Cards.Faction1.RadiantDragoon	FX.Cards.Faction1.RadiantDragoon	app/sdk/cards/factory/shimzar/faction1.coffee
Cards.Faction1.RightfulHeir	FX.Cards.Neutral.TwilightMage	app/sdk/cards/factory/coreshatter/faction1.coffee
Cards.Faction1.Scintilla	FX.Cards.Faction1.Scintilla	app/sdk/cards/factory/bloodstorm/faction1.coffee
Cards.Faction1.SilverguardKnight	FX.Cards.Faction1.SilverguardKnight	app/sdk/cards/factory/core/faction1.coffee
Cards.Faction1.SilverguardSquire	FX.Cards.Faction1.SilverguardSquire	app/sdk/cards/factory/core/faction1.coffee
Cards.Faction1.Slo	FX.Cards.Neutral.Slo	app/sdk/cards/factory/shimzar/faction1.coffee
Cards.Faction1.SolPontiff	FX.Cards.Neutral.BloodshardGolem	app/sdk/cards/factory/unity/faction1.coffee
Cards.Faction1.Solarius	FX.Cards.Faction1.Solarius	app/sdk/cards/factory/shimzar/faction1.coffee
Cards.Faction1.Solpiercer	FX.Cards.Neutral.Solpiercer	app/sdk/cards/factory/firstwatch/faction1.coffee
Cards.Faction1.SunSister	FX.Cards.Faction1.SunSister	app/sdk/cards/factory/monthly/sisters.coffee
Cards.Faction1.SunWisp	FX.Cards.Faction1.SunWisp	app/sdk/cards/factory/shimzar/faction1.coffee
Cards.Faction1.Sunbreaker	FX.Cards.Faction1.Sunriser	app/sdk/cards/factory/bloodstorm/faction1.coffee
Cards.Faction1.SunforgeLancer	FX.Cards.Faction1.SunforgeLancer	app/sdk/cards/factory/shimzar/faction1.coffee
Cards.Faction1.SunriseCleric	FX.Cards.Neutral.DayWatcher	app/sdk/cards/factory/firstwatch/faction1.coffee
Cards.Faction1.Sunriser	FX.Cards.Faction1.Sunriser	app/sdk/cards/factory/core/faction1.coffee
Cards.Faction1.SunstoneTemplar	FX.Cards.Faction1.SunstoneTemplar	app/sdk/cards/factory/core/faction1.coffee
Cards.Faction1.SuntideExpert	FX.Cards.Neutral.Grailmaster	app/sdk/cards/factory/coreshatter/faction1.coffee
Cards.Faction1.SuntideMaiden	FX.Cards.Faction1.SuntideMaiden	app/sdk/cards/factory/core/faction1.coffee
Cards.Faction1.ThirdGeneral	FX.Cards.Faction1.General	app/sdk/cards/factory/core/faction1.coffee
Cards.Faction1.Vigilator	FX.Cards.Faction1.SilverguardSquire	app/sdk/cards/factory/wartech/faction1.coffee
Cards.Faction1.VigilatorBuilding	FX.Cards.Neutral.Bastion	app/sdk/cards/factory/wartech/faction1.coffee
Cards.Faction1.WarJudicator	FX.Cards.Neutral.GoldenJusticar	app/sdk/cards/factory/firstwatch/faction1.coffee
Cards.Faction1.Warblade	FX.Cards.Neutral.SkyrockGolem	app/sdk/cards/factory/unity/faction1.coffee
Cards.Faction1.Warsmith	FX.Cards.Neutral.Warsmith	app/sdk/cards/factory/wartech/faction1.coffee
Cards.Faction1.WindbladeAdept	FX.Cards.Faction1.WindbladeAdept	app/sdk/cards/factory/core/faction1.coffee
Cards.Faction1.WindbladeCommander	FX.Cards.Faction1.WindbladeCommander	app/sdk/cards/factory/core/faction1.coffee
Cards.Faction2.Ace	FX.Cards.Neutral.PandoraMinionZap	app/sdk/cards/factory/shimzar/faction2.coffee
Cards.Faction2.AltGeneral	FX.Cards.Faction2.RevaEventide	app/sdk/cards/factory/core/faction2.coffee
Cards.Faction2.Backbreaker	FX.Cards.Neutral.BloodshardGolem	app/sdk/cards/factory/coreshatter/faction2.coffee
Cards.Faction2.BattlePanddo	FX.Cards.Faction2.BattlePanddo	app/sdk/cards/factory/shimzar/faction2.coffee
Cards.Faction2.Calligrapher	FX.Cards.Faction2.JadeOgre	app/sdk/cards/factory/unity/faction2.coffee
Cards.Faction2.CelestialPhantom	FX.Cards.Faction2.CelestialPhantom	app/sdk/cards/factory/core/faction2.coffee
Cards.Faction2.ChakriAvatar	FX.Cards.Faction2.ChakriAvatar	app/sdk/cards/factory/core/faction2.coffee
Cards.Faction2.CraneWalker	FX.Cards.Neutral.PutridMindflayer	app/sdk/cards/factory/coreshatter/faction2.coffee
Cards.Faction2.DarkHeart	FX.Cards.Neutral.DarkHeart	app/sdk/cards/factory/coreshatter/faction2.coffee
Cards.Faction2.DuskRigger	FX.Cards.Faction6.WolfAspect	app/sdk/cards/factory/wartech/faction2.coffee
Cards.Faction2.EternityPainter	FX.Cards.Neutral.AstralCrusader	app/sdk/cards/factory/firstwatch/faction2.coffee
Cards.Faction2.Flamewreath	FX.Cards.Faction4.DarkSiren	app/sdk/cards/factory/firstwatch/faction2.coffee
Cards.Faction2.Flareslinger	FX.Cards.Faction2.FlareSlinger	app/sdk/cards/factory/coreshatter/faction2.coffee
Cards.Faction2.General	FX.Cards.Faction2.General	app/sdk/cards/factory/core/faction2.coffee
Cards.Faction2.Geomancer	FX.Cards.Faction2.MageOfFourWinds	app/sdk/cards/factory/bloodstorm/faction2.coffee
Cards.Faction2.GoreHorn	FX.Cards.Faction2.GoreHorn	app/sdk/cards/factory/core/faction2.coffee
Cards.Faction2.GrandmasterZendo	FX.Cards.Faction2.GrandmasterZendo	app/sdk/cards/factory/shimzar/faction2.coffee
Cards.Faction2.HamonBlademaster	FX.Cards.Faction2.HamonBlademaster	app/sdk/cards/factory/core/faction2.coffee
Cards.Faction2.Heartseeker	FX.Cards.Faction2.Heartseeker	app/sdk/cards/factory/core/faction2.coffee
Cards.Faction2.HundredHand	FX.Cards.Faction2.JadeOgre	app/sdk/cards/factory/firstwatch/faction2.coffee
Cards.Faction2.JadeOgre	FX.Cards.Faction2.JadeOgre	app/sdk/cards/factory/core/faction2.coffee
Cards.Faction2.KaidoAssassin	FX.Cards.Faction2.KaidoAssassin	app/sdk/cards/factory/core/faction2.coffee
Cards.Faction2.Katara	FX.Cards.Faction2.Katara	app/sdk/cards/factory/shimzar/faction2.coffee
Cards.Faction2.KeshraiFanblade	FX.Cards.Faction2.KeshraiFanblade	app/sdk/cards/factory/core/faction2.coffee
Cards.Faction2.KiBeholder	FX.Cards.Faction2.KiBeholder	app/sdk/cards/factory/shimzar/faction2.coffee
Cards.Faction2.Kindling	FX.Cards.Neutral.Kindling	app/sdk/cards/factory/unity/faction2.coffee
Cards.Faction2.LanternFox	FX.Cards.Faction2.LanternFox	app/sdk/cards/factory/core/faction2.coffee
Cards.Faction2.LightningSister	FX.Cards.Faction2.LightningSister	app/sdk/cards/factory/monthly/sisters.coffee
Cards.Faction2.MageOfFourWinds	FX.Cards.Faction2.MageOfFourWinds	app/sdk/cards/factory/core/faction2.coffee
Cards.Faction2.ManakiteBuilding	FX.Cards.Neutral.Bastion	app/sdk/cards/factory/wartech/faction2.coffee
Cards.Faction2.ManakiteDrifter	FX.Cards.Neutral.DustWailer	app/sdk/cards/factory/wartech/faction2.coffee
Cards.Faction2.MindCageOni	FX.Cards.Faction2.CelestialPhantom	app/sdk/cards/factory/firstwatch/faction2.coffee
Cards.Faction2.Mizuchi	FX.Cards.Neutral.SpottedDragonlark	app/sdk/cards/factory/firstwatch/faction2.coffee
Cards.Faction2.MoveMan	FX.Cards.Neutral.SunSeer	app/sdk/cards/factory/coreshatter/faction2.coffee
Cards.Faction2.OnyxBear	FX.Cards.Faction2.OnyxBear	app/sdk/cards/factory/core/faction2.coffee
Cards.Faction2.OnyxJaguar	FX.Cards.Faction2.OnyxJaguar	app/sdk/cards/factory/shimzar/faction2.coffee
Cards.Faction2.PandaPuncher	FX.Cards.Neutral.DeathBlighter	app/sdk/cards/factory/coreshatter/faction2.coffee
Cards.Faction2.Penumbraxx	FX.Cards.Neutral.VoidHunter	app/sdk/cards/factory/wartech/faction2.coffee
Cards.Faction2.PenumbraxxBuilding	FX.Cards.Neutral.Bastion	app/sdk/cards/factory/wartech/faction2.coffee
Cards.Faction2.ScarletViper	FX.Cards.Faction2.ScarletViper	app/sdk/cards/factory/core/faction2.coffee
Cards.Faction2.ScrollBandit	FX.Cards.Neutral.ProphetWhitePalm	app/sdk/cards/factory/firstwatch/faction2.coffee
Cards.Faction2.SecondSwordSarugi	FX.Cards.Neutral.Eclipse	app/sdk/cards/factory/wartech/faction2.coffee
Cards.Faction2.ShadowSummoner	FX.Cards.Neutral.VineEntangler	app/sdk/cards/factory/coreshatter/faction2.coffee
Cards.Faction2.SonghaiSentinel	FX.Cards.Faction2.KaidoAssassin	app/sdk/cards/factory/firstwatch/faction2.coffee
Cards.Faction2.Sparrowhawk	FX.Cards.Faction2.ScarletViper	app/sdk/cards/factory/unity/faction2.coffee
Cards.Faction2.StormKage	FX.Cards.Faction2.StormKage	app/sdk/cards/factory/core/faction2.coffee
Cards.Faction2.Suzumebachi	FX.Cards.Neutral.ProphetWhitePalm	app/sdk/cards/factory/wartech/faction2.coffee
Cards.Faction2.ThirdGeneral	FX.Cards.Faction2.RevaEventide	app/sdk/cards/factory/core/faction2.coffee
Cards.Faction2.TuskBoar	FX.Cards.Faction2.TuskBoar	app/sdk/cards/factory/core/faction2.coffee
Cards.Faction2.TwilightFox	FX.Cards.Faction2.LanternFox	app/sdk/cards/factory/bloodstorm/faction2.coffee
Cards.Faction2.Whiplash	FX.Cards.Faction2.KaidoAssassin	app/sdk/cards/factory/bloodstorm/faction2.coffee
Cards.Faction2.Widowmaker	FX.Cards.Faction2.Widowmaker	app/sdk/cards/factory/core/faction2.coffee
Cards.Faction2.WildfireTenketsu	FX.Cards.Neutral.Mindwarper	app/sdk/cards/factory/wartech/faction2.coffee
Cards.Faction2.Xho	FX.Cards.Neutral.Xho	app/sdk/cards/factory/shimzar/faction2.coffee
Cards.Faction3.Allomancer	FX.Cards.Faction3.Allomancer	app/sdk/cards/factory/shimzar/faction3.coffee
Cards.Faction3.AltGeneral	FX.Cards.Faction3.ScionessSajj	app/sdk/cards/factory/core/faction3.coffee
Cards.Faction3.AymaraHealer	FX.Cards.Faction3.AymaraHealer	app/sdk/cards/factory/core/faction3.coffee
Cards.Faction3.BarrenShrike	FX.Cards.Neutral.LightningBeetle	app/sdk/cards/factory/wartech/faction3.coffee
Cards.Faction3.BrazierDuskWind	FX.Cards.Faction3.BrazierDuskWind	app/sdk/cards/factory/core/faction3.coffee
Cards.Faction3.BrazierGoldenFlame	FX.Cards.Faction3.BrazierGoldenFlame	app/sdk/cards/factory/core/faction3.coffee
Cards.Faction3.BrazierRedSand	FX.Cards.Faction3.BrazierRedSand	app/sdk/cards/factory/core/faction3.coffee
Cards.Faction3.CoughingGus	FX.Cards.Neutral.SunElemental	app/sdk/cards/factory/coreshatter/faction3.coffee
Cards.Faction3.CursedDervish	FX.Cards.Neutral.WhiteWidow	app/sdk/cards/factory/coreshatter/faction3.coffee
Cards.Faction3.Dervish	FX.Cards.Faction3.Dervish	app/sdk/cards/factory/core/faction3.coffee
Cards.Faction3.Dreamcarver	FX.Cards.Neutral.SkyrockGolem	app/sdk/cards/factory/unity/faction3.coffee
Cards.Faction3.Dunecaster	FX.Cards.Faction3.Dunecaster	app/sdk/cards/factory/core/faction3.coffee
Cards.Faction3.Duskweaver	FX.Cards.Neutral.WhiteWidow	app/sdk/cards/factory/firstwatch/faction3.coffee
Cards.Faction3.Falcius	FX.Cards.Faction3.Falcius	app/sdk/cards/factory/shimzar/faction3.coffee
Cards.Faction3.FateWatcher	FX.Cards.Neutral.Necroseer	app/sdk/cards/factory/firstwatch/faction3.coffee
Cards.Faction3.General	FX.Cards.Faction3.General	app/sdk/cards/factory/core/faction3.coffee
Cards.Faction3.GoldenGuide	FX.Cards.Neutral.Fireblazer	app/sdk/cards/factory/coreshatter/faction3.coffee
Cards.Faction3.GrandmasterNoshRak	FX.Cards.Faction3.GrandmasterNoshRak	app/sdk/cards/factory/bloodstorm/faction3.coffee
Cards.Faction3.Gust	FX.Cards.Neutral.Zephyr	app/sdk/cards/factory/wartech/faction3.coffee
Cards.Faction3.Incinera	FX.Cards.Faction3.StarfireScarab	app/sdk/cards/factory/bloodstorm/faction3.coffee
Cards.Faction3.IronDervish	FX.Cards.Faction3.Dervish	app/sdk/cards/factory/core/faction3.coffee
Cards.Faction3.KeeperOfAges	FX.Cards.Neutral.SwornDefender	app/sdk/cards/factory/coreshatter/faction3.coffee
Cards.Faction3.LavastormObelysk	FX.Cards.Neutral.Bastion	app/sdk/cards/factory/firstwatch/faction3.coffee
Cards.Faction3.MirrorMaster	FX.Cards.Faction3.MirrorMaster	app/sdk/cards/factory/core/faction3.coffee
Cards.Faction3.NightfallMechanyst	FX.Cards.Faction3.NightfallMechanyst	app/sdk/cards/factory/core/faction3.coffee
Cards.Faction3.Nimbus	FX.Cards.Faction3.Nimbus	app/sdk/cards/factory/shimzar/faction3.coffee
Cards.Faction3.OrbWeaver	FX.Cards.Faction3.OrbWeaver	app/sdk/cards/factory/core/faction3.coffee
Cards.Faction3.Oserix	FX.Cards.Faction3.Oserix	app/sdk/cards/factory/core/faction3.coffee
Cards.Faction3.Pantheran	FX.Cards.Faction3.Pantheran	app/sdk/cards/factory/shimzar/faction3.coffee
Cards.Faction3.Pax	FX.Cards.Neutral.Nip	app/sdk/cards/factory/shimzar/faction3.coffee
Cards.Faction3.PlagueTotem	FX.Cards.Faction3.BrazierDuskWind	app/sdk/cards/factory/shimzar/faction3.coffee
Cards.Faction3.PortalGuardian	FX.Cards.Faction3.PortalGuardian	app/sdk/cards/factory/core/faction3.coffee
Cards.Faction3.Pyromancer	FX.Cards.Faction3.Pyromancer	app/sdk/cards/factory/core/faction3.coffee
Cards.Faction3.Rae	FX.Cards.Neutral.Nip	app/sdk/cards/factory/shimzar/faction3.coffee
Cards.Faction3.SandHowler	FX.Cards.Faction3.SandHowler	app/sdk/cards/factory/core/faction3.coffee
Cards.Faction3.SandSister	FX.Cards.Faction3.SandSister	app/sdk/cards/factory/monthly/sisters.coffee
Cards.Faction3.SandswirlReader	FX.Cards.Neutral.Spelljammer	app/sdk/cards/factory/firstwatch/faction3.coffee
Cards.Faction3.Scarab	FX.Cards.Neutral.BlackLocust	app/sdk/cards/factory/coreshatter/faction3.coffee
Cards.Faction3.ScarabPulverizer	FX.Cards.Neutral.Serpenti	app/sdk/cards/factory/coreshatter/faction3.coffee
Cards.Faction3.ShrikeBuilding	FX.Cards.Neutral.Bastion	app/sdk/cards/factory/wartech/faction3.coffee
Cards.Faction3.SilicaWeaver	FX.Cards.Neutral.SilicaWeaver	app/sdk/cards/factory/wartech/faction3.coffee
Cards.Faction3.SimulacraBuilding	FX.Cards.Neutral.Bastion	app/sdk/cards/factory/wartech/faction3.coffee
Cards.Faction3.SimulacraObelysk	FX.Cards.Faction3.BrazierRedSand	app/sdk/cards/factory/wartech/faction3.coffee
Cards.Faction3.Sirocco	FX.Cards.Neutral.StormmetalGolem	app/sdk/cards/factory/unity/faction3.coffee
Cards.Faction3.Skyppy	FX.Cards.Neutral.Bonereaper	app/sdk/cards/factory/wartech/faction3.coffee
Cards.Faction3.SniperZen	FX.Cards.Neutral.AzureHornShaman	app/sdk/cards/factory/wartech/faction3.coffee
Cards.Faction3.SoulburnObelysk	FX.Cards.Faction3.BrazierDuskWind	app/sdk/cards/factory/shimzar/faction3.coffee
Cards.Faction3.StaffWielder	FX.Cards.Neutral.ArakiHeadhunter	app/sdk/cards/factory/coreshatter/faction3.coffee
Cards.Faction3.StarfireScarab	FX.Cards.Faction3.StarfireScarab	app/sdk/cards/factory/core/faction3.coffee
Cards.Faction3.ThirdGeneral	FX.Cards.Faction3.General	app/sdk/cards/factory/core/faction3.coffee
Cards.Faction3.TrygonObelysk	FX.Cards.Faction3.BrazierDuskWind	app/sdk/cards/factory/firstwatch/faction3.coffee
Cards.Faction3.WastelandWraith	FX.Cards.Neutral.BlackSandBurrower	app/sdk/cards/factory/firstwatch/faction3.coffee
Cards.Faction3.WindGiver	FX.Cards.Neutral.Spelljammer	app/sdk/cards/factory/coreshatter/faction3.coffee
Cards.Faction3.WindShrike	FX.Cards.Faction3.WindShrike	app/sdk/cards/factory/core/faction3.coffee
Cards.Faction3.WindSlicer	FX.Cards.Neutral.Sojourner	app/sdk/cards/factory/shimzar/faction3.coffee
Cards.Faction3.Windlark	FX.Cards.Faction3.WindShrike	app/sdk/cards/factory/unity/faction3.coffee
Cards.Faction3.Zephyr	FX.Cards.Faction3.OrbWeaver	app/sdk/cards/factory/bloodstorm/faction3.coffee
Cards.Faction4.Abomination	FX.Cards.Faction4.Abomination	app/sdk/cards/factory/wartech/faction4.coffee
Cards.Faction4.AbyssSentinel	FX.Cards.Faction4.ShadowWatcher	app/sdk/cards/factory/firstwatch/faction4.coffee
Cards.Faction4.AbyssalCrawler	FX.Cards.Faction4.AbyssalCrawler	app/sdk/cards/factory/core/faction4.coffee
Cards.Faction4.AbyssalJuggernaut	FX.Cards.Faction4.AbyssalJuggernaut	app/sdk/cards/factory/core/faction4.coffee
Cards.Faction4.AltGeneral	FX.Cards.Faction4.CassyvaSoulreaper	app/sdk/cards/factory/core/faction4.coffee
Cards.Faction4.ArcaneDevourer	FX.Cards.Faction4.ArcaneDevourer	app/sdk/cards/factory/shimzar/faction4.coffee
Cards.Faction4.BlackSolus	FX.Cards.Faction4.BlackSolus	app/sdk/cards/factory/core/faction4.coffee
Cards.Faction4.BloodBaronette	FX.Cards.Faction4.BloodBaronette	app/sdk/cards/factory/shimzar/faction4.coffee
Cards.Faction4.BloodmoonPriestess	FX.Cards.Faction4.BloodmoonPriestess	app/sdk/cards/factory/core/faction4.coffee
Cards.Faction4.BoundTormentor	FX.Cards.Faction2.JadeOgre	app/sdk/cards/factory/firstwatch/faction4.coffee
Cards.Faction4.Cacophynos	FX.Cards.Neutral.FirstSwordofAkrane	app/sdk/cards/factory/wartech/faction4.coffee
Cards.Faction4.CreepDemon	FX.Cards.Neutral.LightningBeetle	app/sdk/cards/factory/coreshatter/faction4.coffee
Cards.Faction4.CurseMonger	FX.Cards.Neutral.Necroseer	app/sdk/cards/factory/coreshatter/faction4.coffee
Cards.Faction4.DarkSiren	FX.Cards.Faction4.DarkSiren	app/sdk/cards/factory/core/faction4.coffee
Cards.Faction4.DarkspineElemental	FX.Cards.Faction4.DarkspineElemental	app/sdk/cards/factory/core/faction4.coffee
Cards.Faction4.DeathKnell	FX.Cards.Faction4.DeathKnell	app/sdk/cards/factory/unity/faction4.coffee
Cards.Faction4.DeepfireDevourer	FX.Cards.Faction4.DeepfireDevourer	app/sdk/cards/factory/core/faction4.coffee
Cards.Faction4.DemonOfEternity	FX.Cards.Faction4.HuntingHorror	app/sdk/cards/factory/coreshatter/faction4.coffee
Cards.Faction4.Desolator	FX.Cards.Neutral.Moebius	app/sdk/cards/factory/firstwatch/faction4.coffee
Cards.Faction4.DyingWishReducer	FX.Cards.Neutral.SilvertongueCorsair	app/sdk/cards/factory/coreshatter/faction4.coffee
Cards.Faction4.Fiend	FX.Cards.Faction4.DarkspineElemental	app/sdk/cards/factory/bloodstorm/faction4.coffee
Cards.Faction4.Furosa	FX.Cards.Faction4.AbyssalCrawler	app/sdk/cards/factory/bloodstorm/faction4.coffee
Cards.Faction4.GateBuilding	FX.Cards.Neutral.Bastion	app/sdk/cards/factory/wartech/faction4.coffee
Cards.Faction4.GateToUndervault	FX.Cards.Faction3.BrazierDuskWind	app/sdk/cards/factory/wartech/faction4.coffee
Cards.Faction4.General	FX.Cards.Faction4.General	app/sdk/cards/factory/core/faction4.coffee
Cards.Faction4.GloomChaser	FX.Cards.Faction4.GloomChaser	app/sdk/cards/factory/core/faction4.coffee
Cards.Faction4.Gor	FX.Cards.Neutral.Gor	app/sdk/cards/factory/shimzar/faction4.coffee
Cards.Faction4.GrandmasterVariax	FX.Cards.Faction4.SharianShadowdancer	app/sdk/cards/factory/bloodstorm/faction4.coffee
Cards.Faction4.Horror	FX.Cards.Faction4.Horror	app/sdk/cards/factory/bloodstorm/faction4.coffee
Cards.Faction4.HorrorBurster	FX.Cards.Faction4.HorrorBurster	app/sdk/cards/factory/bloodstorm/faction4.coffee
Cards.Faction4.Husk	FX.Cards.Neutral.Serpenti	app/sdk/cards/factory/core/faction4.coffee
Cards.Faction4.Klaxon	FX.Cards.Faction4.Klaxon	app/sdk/cards/factory/shimzar/faction4.coffee
Cards.Faction4.MiniMinion	FX.Cards.Neutral.Fog	app/sdk/cards/factory/coreshatter/faction4.coffee
Cards.Faction4.Moonrider	FX.Cards.Neutral.ArchonSpellbinder	app/sdk/cards/factory/wartech/faction4.coffee
Cards.Faction4.Nekomata	FX.Cards.Neutral.PutridMindflayer	app/sdk/cards/factory/firstwatch/faction4.coffee
Cards.Faction4.NightFiend	FX.Cards.Faction4.DarkSiren	app/sdk/cards/factory/shimzar/faction4.coffee
Cards.Faction4.NightmareOperant	FX.Cards.Neutral.Amu	app/sdk/cards/factory/wartech/faction4.coffee
Cards.Faction4.Nightshroud	FX.Cards.Faction4.Nightshroud	app/sdk/cards/factory/unity/faction4.coffee
Cards.Faction4.NightsorrowAssassin	FX.Cards.Faction4.NightsorrowAssassin	app/sdk/cards/factory/core/faction4.coffee
Cards.Faction4.Nocturne	FX.Cards.Faction4.GloomChaser	app/sdk/cards/factory/unity/faction4.coffee
Cards.Faction4.Ooz	FX.Cards.Neutral.Gor	app/sdk/cards/factory/shimzar/faction4.coffee
Cards.Faction4.Phantasm	FX.Cards.Faction4.DarkSiren	app/sdk/cards/factory/firstwatch/faction4.coffee
Cards.Faction4.ReaperNineMoons	FX.Cards.Faction4.ReaperNineMoons	app/sdk/cards/factory/core/faction4.coffee
Cards.Faction4.ShadowBrute	FX.Cards.Neutral.SilhoutteTracer	app/sdk/cards/factory/coreshatter/faction4.coffee
Cards.Faction4.ShadowSister	FX.Cards.Faction4.ShadowSister	app/sdk/cards/factory/monthly/sisters.coffee
Cards.Faction4.ShadowWatcher	FX.Cards.Faction4.ShadowWatcher	app/sdk/cards/factory/core/faction4.coffee
Cards.Faction4.SharianShadowdancer	FX.Cards.Faction4.SharianShadowdancer	app/sdk/cards/factory/core/faction4.coffee
Cards.Faction4.SkullProphet	FX.Cards.Faction4.SkullCaster	app/sdk/cards/factory/firstwatch/faction4.coffee
Cards.Faction4.SpectralRevenant	FX.Cards.Faction4.SpectralRevenant	app/sdk/cards/factory/core/faction4.coffee
Cards.Faction4.StygianObserver	FX.Cards.Neutral.DarkNemesis	app/sdk/cards/factory/wartech/faction4.coffee
Cards.Faction4.ThirdGeneral	FX.Cards.Faction4.CassyvaSoulreaper	app/sdk/cards/factory/core/faction4.coffee
Cards.Faction4.VoidTalon	FX.Cards.Neutral.BluetipScorpion	app/sdk/cards/factory/wartech/faction4.coffee
Cards.Faction4.VoidTalonBuilding	FX.Cards.Neutral.Bastion	app/sdk/cards/factory/wartech/faction4.coffee
Cards.Faction4.VorpalReaver	FX.Cards.Faction4.VorpalReaver	app/sdk/cards/factory/core/faction4.coffee
Cards.Faction4.WhistlingHarvester	FX.Cards.Neutral.FrostboneNaga	app/sdk/cards/factory/coreshatter/faction4.coffee
Cards.Faction4.Wraithling	FX.Cards.Faction4.Wraithling	app/sdk/cards/factory/core/faction4.coffee
Cards.Faction4.Xerroloth	FX.Cards.Faction2.CelestialPhantom	app/sdk/cards/factory/firstwatch/faction4.coffee
Cards.Faction5.AltGeneral	FX.Cards.Faction5.Starhorn	app/sdk/cards/factory/core/faction5.coffee
Cards.Faction5.Armada	FX.Cards.Neutral.Quahog	app/sdk/cards/factory/wartech/faction5.coffee
Cards.Faction5.Armadops	FX.Cards.Neutral.ThornNeedler	app/sdk/cards/factory/coreshatter/faction5.coffee
Cards.Faction5.BioHulk	FX.Cards.Neutral.WhistlingBlade	app/sdk/cards/factory/wartech/faction5.coffee
Cards.Faction5.BrundlBeast	FX.Cards.Faction2.CelestialPhantom	app/sdk/cards/factory/coreshatter/faction5.coffee
Cards.Faction5.BurstLizard	FX.Cards.Neutral.BlisteringSkorn	app/sdk/cards/factory/coreshatter/faction5.coffee
Cards.Faction5.Dinomancer	FX.Cards.Neutral.Ironclad	app/sdk/cards/factory/coreshatter/faction5.coffee
Cards.Faction5.Dreadnaught	FX.Cards.Faction5.Dreadnaught	app/sdk/cards/factory/shimzar/faction5.coffee
Cards.Faction5.Drogon	FX.Cards.Faction5.EarthWalker	app/sdk/cards/factory/bloodstorm/faction5.coffee
Cards.Faction5.EarthSister	FX.Cards.Faction5.EarthSister	app/sdk/cards/factory/monthly/sisters.coffee
Cards.Faction5.EarthWalker	FX.Cards.Faction5.EarthWalker	app/sdk/cards/factory/core/faction5.coffee
Cards.Faction5.Egg	FX.Cards.Faction5.Egg	app/sdk/cards/factory/core/faction5.coffee
Cards.Faction5.Elucidator	FX.Cards.Faction5.Elucidator	app/sdk/cards/factory/core/faction5.coffee
Cards.Faction5.ErraticRaptyr	FX.Cards.Neutral.TheHighHand	app/sdk/cards/factory/wartech/faction5.coffee
Cards.Faction5.Firebreather	FX.Cards.Faction5.Firebreather	app/sdk/cards/factory/coreshatter/faction5.coffee
Cards.Faction5.General	FX.Cards.Faction5.General	app/sdk/cards/factory/core/faction5.coffee
Cards.Faction5.Gibblegup	FX.Cards.Faction5.MiniMagmar	app/sdk/cards/factory/core/faction5.coffee
Cards.Faction5.Gigaloth	FX.Cards.Neutral.WarTalon	app/sdk/cards/factory/wartech/faction5.coffee
Cards.Faction5.GigalothBuilding	FX.Cards.Neutral.Bastion	app/sdk/cards/factory/wartech/faction5.coffee
Cards.Faction5.GrandmasterKraigon	FX.Cards.Neutral.Paddo	app/sdk/cards/factory/firstwatch/faction5.coffee
Cards.Faction5.Grimrock	FX.Cards.Faction5.Grimrock	app/sdk/cards/factory/core/faction5.coffee
Cards.Faction5.Gro	FX.Cards.Neutral.Gro	app/sdk/cards/factory/shimzar/faction5.coffee
Cards.Faction5.HulkBuilding	FX.Cards.Neutral.Bastion	app/sdk/cards/factory/wartech/faction5.coffee
Cards.Faction5.IncreasingDino	FX.Cards.Neutral.VineEntangler	app/sdk/cards/factory/coreshatter/faction5.coffee
Cards.Faction5.Juggernaut	FX.Cards.Faction5.UnstableLeviathan	app/sdk/cards/factory/unity/faction5.coffee
Cards.Faction5.Kin	FX.Cards.Faction5.Kin	app/sdk/cards/factory/shimzar/faction5.coffee
Cards.Faction5.Kolossus	FX.Cards.Faction5.Kolossus	app/sdk/cards/factory/core/faction5.coffee
Cards.Faction5.Kujata	FX.Cards.Faction5.Kujata	app/sdk/cards/factory/core/faction5.coffee
Cards.Faction5.Lavaslasher	FX.Cards.Neutral.Yun	app/sdk/cards/factory/unity/faction5.coffee
Cards.Faction5.MakantorWarbeast	FX.Cards.Faction5.MakantorWarbeast	app/sdk/cards/factory/core/faction5.coffee
Cards.Faction5.Mandrake	FX.Cards.Faction5.Mandrake	app/sdk/cards/factory/shimzar/faction5.coffee
Cards.Faction5.Megabrontodon	FX.Cards.Neutral.Khymera	app/sdk/cards/factory/coreshatter/faction5.coffee
Cards.Faction5.MiniMagmar	FX.Cards.Faction5.MiniMagmar	app/sdk/cards/factory/core/faction5.coffee
Cards.Faction5.MolokiHuntress	FX.Cards.Faction5.MolokiHuntress	app/sdk/cards/factory/shimzar/faction5.coffee
Cards.Faction5.Omniseer	FX.Cards.Faction5.Omniseer	app/sdk/cards/factory/firstwatch/faction5.coffee
Cards.Faction5.Phalanxar	FX.Cards.Faction5.Phalanxar	app/sdk/cards/factory/core/faction5.coffee
Cards.Faction5.PrimordialGazer	FX.Cards.Faction5.PrimordialGazer	app/sdk/cards/factory/core/faction5.coffee
Cards.Faction5.Progenitor	FX.Cards.Neutral.Progenitor	app/sdk/cards/factory/wartech/faction5.coffee
Cards.Faction5.Quillbeast	FX.Cards.Neutral.BlisteringSkorn	app/sdk/cards/factory/firstwatch/faction5.coffee
Cards.Faction5.Ragebinder	FX.Cards.Neutral.BrightmossGolem	app/sdk/cards/factory/unity/faction5.coffee
Cards.Faction5.Rancour	FX.Cards.Faction5.PrimordialGazer	app/sdk/cards/factory/bloodstorm/faction5.coffee
Cards.Faction5.Rex	FX.Cards.Faction5.Rex	app/sdk/cards/factory/shimzar/faction5.coffee
Cards.Faction5.Rizen	FX.Cards.Neutral.ThornNeedler	app/sdk/cards/factory/firstwatch/faction5.coffee
Cards.Faction5.Seismoid	FX.Cards.Neutral.Xho	app/sdk/cards/factory/wartech/faction5.coffee
Cards.Faction5.SilitharElder	FX.Cards.Faction5.SilitharElder	app/sdk/cards/factory/core/faction5.coffee
Cards.Faction5.SpiritHarvester	FX.Cards.Faction5.SpiritHarvester	app/sdk/cards/factory/core/faction5.coffee
Cards.Faction5.SpiritOfValknu	FX.Cards.Faction5.SpiritOfValknu	app/sdk/cards/factory/bloodstorm/faction5.coffee
Cards.Faction5.Terradon	FX.Cards.Neutral.VineEntangler	app/sdk/cards/factory/firstwatch/faction5.coffee
Cards.Faction5.ThirdGeneral	FX.Cards.Faction5.Starhorn	app/sdk/cards/factory/core/faction5.coffee
Cards.Faction5.Thraex	FX.Cards.Neutral.Thraex	app/sdk/cards/factory/bloodstorm/faction5.coffee
Cards.Faction5.ToughDino	FX.Cards.Neutral.RazorcragGolem	app/sdk/cards/factory/coreshatter/faction5.coffee
Cards.Faction5.UnstableLeviathan	FX.Cards.Faction5.UnstableLeviathan	app/sdk/cards/factory/core/faction5.coffee
Cards.Faction5.VeteranSilithar	FX.Cards.Faction5.VeteranSilithar	app/sdk/cards/factory/core/faction5.coffee
Cards.Faction5.Vindicator	FX.Cards.Faction5.Vindicator	app/sdk/cards/factory/core/faction5.coffee
Cards.Faction5.Visionar	FX.Cards.Faction5.Dreadnaught	app/sdk/cards/factory/shimzar/faction5.coffee
Cards.Faction5.Warpup	FX.Cards.Neutral.KomodoCharger	app/sdk/cards/factory/firstwatch/faction5.coffee
Cards.Faction5.WildInceptor	FX.Cards.Neutral.Spelljammer	app/sdk/cards/factory/shimzar/faction5.coffee
Cards.Faction5.YoungSilithar	FX.Cards.Faction5.YoungSilithar	app/sdk/cards/factory/core/faction5.coffee
Cards.Faction6.AltGeneral	FX.Cards.Faction6.KaraWinterblade	app/sdk/cards/factory/core/faction6.coffee
Cards.Faction6.AncientGrove	FX.Cards.Faction6.AncientGrove	app/sdk/cards/factory/core/faction6.coffee
Cards.Faction6.ArcticDisplacer	FX.Cards.Faction6.ArcticDisplacer	app/sdk/cards/factory/core/faction6.coffee
Cards.Faction6.ArcticRhyno	FX.Cards.Faction6.ArcticRhyno	app/sdk/cards/factory/core/faction6.coffee
Cards.Faction6.AzureDrake	FX.Cards.Faction6.AzureDrake	app/sdk/cards/factory/core/faction6.coffee
Cards.Faction6.BlazingSpines	FX.Cards.Faction6.BlazingSpines	app/sdk/cards/factory/core/faction6.coffee
Cards.Faction6.BonechillBarrier	FX.Cards.Faction6.BonechillBarrier	app/sdk/cards/factory/core/faction6.coffee
Cards.Faction6.BoreanBear	FX.Cards.Faction6.BoreanBear	app/sdk/cards/factory/core/faction6.coffee
Cards.Faction6.Bur	FX.Cards.Neutral.Nip	app/sdk/cards/factory/shimzar/faction6.coffee
Cards.Faction6.Circulus	FX.Cards.Neutral.KomodoCharger	app/sdk/cards/factory/unity/faction6.coffee
Cards.Faction6.CrystalArbiter	FX.Cards.Neutral.Amu	app/sdk/cards/factory/firstwatch/faction6.coffee
Cards.Faction6.CrystalCloaker	FX.Cards.Faction6.CrystalCloaker	app/sdk/cards/factory/core/faction6.coffee
Cards.Faction6.CrystalWisp	FX.Cards.Faction6.CrystalWisp	app/sdk/cards/factory/core/faction6.coffee
Cards.Faction6.DrakeDowager	FX.Cards.Neutral.DrakeDowager	app/sdk/cards/factory/firstwatch/faction6.coffee
Cards.Faction6.DraugarEyolith	FX.Cards.Faction6.AncientGrove	app/sdk/cards/factory/wartech/faction6.coffee
Cards.Faction6.EchoDeliverant	FX.Cards.Neutral.SwornDefender	app/sdk/cards/factory/wartech/faction6.coffee
Cards.Faction6.EyolithBuilding	FX.Cards.Neutral.Bastion	app/sdk/cards/factory/wartech/faction6.coffee
Cards.Faction6.FenrirWarmaster	FX.Cards.Faction6.FenrirWarmaster	app/sdk/cards/factory/core/faction6.coffee
Cards.Faction6.Freeblade	FX.Cards.Faction6.Freeblade	app/sdk/cards/factory/firstwatch/faction6.coffee
Cards.Faction6.FrostBomb	FX.Cards.Neutral.VineEntangler	app/sdk/cards/factory/firstwatch/faction6.coffee
Cards.Faction6.FrostbladeFiend	FX.Cards.Neutral.Sojourner	app/sdk/cards/factory/wartech/faction6.coffee
Cards.Faction6.Frostiva	FX.Cards.Faction6.WolfAspect	app/sdk/cards/factory/shimzar/faction6.coffee
Cards.Faction6.General	FX.Cards.Faction6.General	app/sdk/cards/factory/core/faction6.coffee
Cards.Faction6.GhostWolf	FX.Cards.Faction6.GhostWolf	app/sdk/cards/factory/core/faction6.coffee
Cards.Faction6.GrandmasterEmbla	FX.Cards.Faction6.GrandmasterEmbla	app/sdk/cards/factory/bloodstorm/faction6.coffee
Cards.Faction6.GravityWell	FX.Cards.Faction6.GravityWell	app/sdk/cards/factory/core/faction6.coffee
Cards.Faction6.HearthSister	FX.Cards.Faction6.HearthSister	app/sdk/cards/factory/core/faction6.coffee
Cards.Faction6.Huldra	FX.Cards.Faction6.Huldra	app/sdk/cards/factory/shimzar/faction6.coffee
Cards.Faction6.Hydrogarm	FX.Cards.Neutral.CrimsonOculus	app/sdk/cards/factory/wartech/faction6.coffee
Cards.Faction6.IceDrake	FX.Cards.Neutral.IceDrake	app/sdk/cards/factory/core/faction6.coffee
Cards.Faction6.IceDryad	FX.Cards.Faction6.IceDryad	app/sdk/cards/factory/shimzar/faction6.coffee
Cards.Faction6.Icy	FX.Cards.Neutral.Icy	app/sdk/cards/factory/shimzar/faction6.coffee
Cards.Faction6.InfiltrateMaster	FX.Cards.Faction5.MolokiHuntress	app/sdk/cards/factory/wartech/faction6.coffee
Cards.Faction6.KindredHunter	FX.Cards.Neutral.VoidHunter	app/sdk/cards/factory/unity/faction6.coffee
Cards.Faction6.ManaThief	FX.Cards.Neutral.EXun	app/sdk/cards/factory/coreshatter/faction6.coffee
Cards.Faction6.MatronElveiti	FX.Cards.Neutral.EXun	app/sdk/cards/factory/firstwatch/faction6.coffee
Cards.Faction6.MoonlitBasilysk	FX.Cards.Faction2.CelestialPhantom	app/sdk/cards/factory/firstwatch/faction6.coffee
Cards.Faction6.Myriad	FX.Cards.Faction6.VoiceoftheWind	app/sdk/cards/factory/bloodstorm/faction6.coffee
Cards.Faction6.PrismaticGiant	FX.Cards.Faction6.PrismaticGiant	app/sdk/cards/factory/core/faction6.coffee
Cards.Faction6.Protosensor	FX.Cards.Neutral.VineEntangler	app/sdk/cards/factory/wartech/faction6.coffee
Cards.Faction6.ProtosensorBuilding	FX.Cards.Neutral.Bastion	app/sdk/cards/factory/wartech/faction6.coffee
Cards.Faction6.Razorback	FX.Cards.Faction6.Razorback	app/sdk/cards/factory/core/faction6.coffee
Cards.Faction6.Rootmancer	FX.Cards.Neutral.Amu	app/sdk/cards/factory/coreshatter/faction6.coffee
Cards.Faction6.SeismicElemental	FX.Cards.Faction6.SeismicElemental	app/sdk/cards/factory/core/faction6.coffee
Cards.Faction6.ShadowVespyr	FX.Cards.Faction6.WaterBear	app/sdk/cards/factory/shimzar/faction6.coffee
Cards.Faction6.Shivers	FX.Cards.Neutral.SpottedDragonlark	app/sdk/cards/factory/firstwatch/faction6.coffee
Cards.Faction6.SleetDasher	FX.Cards.Faction6.BoreanBear	app/sdk/cards/factory/bloodstorm/faction6.coffee
Cards.Faction6.SnowElemental	FX.Cards.Faction6.SnowElemental	app/sdk/cards/factory/core/faction6.coffee
Cards.Faction6.SnowRippler	FX.Cards.Faction6.SnowRippler	app/sdk/cards/factory/shimzar/faction6.coffee
Cards.Faction6.SnowWinkle	FX.Cards.Neutral.DragoneboneGolem	app/sdk/cards/factory/coreshatter/faction6.coffee
Cards.Faction6.Snowballer	FX.Cards.Neutral.ZenRui	app/sdk/cards/factory/coreshatter/faction6.coffee
Cards.Faction6.StunBeast	FX.Cards.Neutral.OwlbeastSage	app/sdk/cards/factory/coreshatter/faction6.coffee
Cards.Faction6.StunWarlock	FX.Cards.Neutral.AzureHornShaman	app/sdk/cards/factory/coreshatter/faction6.coffee
Cards.Faction6.SuperFenrir	FX.Cards.Neutral.Shuffler	app/sdk/cards/factory/coreshatter/faction6.coffee
Cards.Faction6.ThirdGeneral	FX.Cards.Faction6.KaraWinterblade	app/sdk/cards/factory/core/faction6.coffee
Cards.Faction6.Treant	FX.Cards.Faction6.Treant	app/sdk/cards/factory/core/faction6.coffee
Cards.Faction6.Ursaplomb	FX.Cards.Neutral.Fireblazer	app/sdk/cards/factory/wartech/faction6.coffee
Cards.Faction6.VanarQuest	FX.Cards.Neutral.TwilightMage	app/sdk/cards/factory/coreshatter/faction6.coffee
Cards.Faction6.VanarSentinel	FX.Cards.Faction6.VanarSentinel	app/sdk/cards/factory/firstwatch/faction6.coffee
Cards.Faction6.VoiceoftheWind	FX.Cards.Faction6.VoiceoftheWind	app/sdk/cards/factory/core/faction6.coffee
Cards.Faction6.WaterBear	FX.Cards.Faction6.WaterBear	app/sdk/cards/factory/core/faction6.coffee
Cards.Faction6.WindSister	FX.Cards.Faction6.WindSister	app/sdk/cards/factory/monthly/sisters.coffee
Cards.Faction6.WolfAspect	FX.Cards.Faction6.WolfAspect	app/sdk/cards/factory/core/faction6.coffee
Cards.Faction6.WolfRaven	FX.Cards.Faction6.WolfRaven	app/sdk/cards/factory/core/faction6.coffee
Cards.Faction6.WyrBeast	FX.Cards.Faction6.WyrBeast	app/sdk/cards/factory/core/faction6.coffee
Cards.Neutral.Abjudicator	FX.Cards.Neutral.Abjudicator	app/sdk/cards/factory/monthly/m8_rexx.coffee
Cards.Neutral.AerOwlblade	FX.Cards.Neutral.WindStopper	app/sdk/cards/factory/coreshatter/neutral.coffee
Cards.Neutral.Aethermaster	FX.Cards.Neutral.Aethermaster	app/sdk/cards/factory/core/neutral.coffee
Cards.Neutral.AlcuinLoremaster	FX.Cards.Neutral.AlcuinLoremaster	app/sdk/cards/factory/core/neutral.coffee
Cards.Neutral.AlterRexx	FX.Cards.Neutral.AlterRexx	app/sdk/cards/factory/monthly/m8_rexx.coffee
Cards.Neutral.Amu	FX.Cards.Neutral.Amu	app/sdk/cards/factory/shimzar/neutral.coffee
Cards.Neutral.ArakiHeadhunter	FX.Cards.Neutral.ArakiHeadhunter	app/sdk/cards/factory/monthly/m3_opening_gambit_buff.coffee
Cards.Neutral.ArarasShuffler	FX.Cards.Neutral.AlterRexx	app/sdk/cards/factory/coreshatter/neutral.coffee
Cards.Neutral.ArcaneIllusion	FX.Cards.Neutral.ArcaneIllusion	app/sdk/cards/factory/core/neutral.coffee
Cards.Neutral.ArchitectBuilding	FX.Cards.Neutral.Bastion	app/sdk/cards/factory/wartech/neutral.coffee
Cards.Neutral.ArchitectT2K5	FX.Cards.Neutral.SunElemental	app/sdk/cards/factory/wartech/neutral.coffee
Cards.Neutral.ArchonSpellbinder	FX.Cards.Neutral.ArchonSpellbinder	app/sdk/cards/factory/core/neutral.coffee
Cards.Neutral.ArrowWhistler	FX.Cards.Neutral.ArrowWhistler	app/sdk/cards/factory/monthly/m7_warmasters.coffee
Cards.Neutral.ArtifactHunter	FX.Cards.Neutral.ArtifactHunter	app/sdk/cards/factory/core/neutral.coffee
Cards.Neutral.Artificer	FX.Cards.Neutral.AzureHornShaman	app/sdk/cards/factory/wartech/neutral.coffee
Cards.Neutral.AshMephyt	FX.Cards.Neutral.AshMephyt	app/sdk/cards/factory/core/neutral.coffee
Cards.Neutral.AstralCrusader	FX.Cards.Neutral.AstralCrusader	app/sdk/cards/factory/monthly/m4_replace.coffee
Cards.Neutral.AzureHerald	FX.Cards.Neutral.AzureHerald	app/sdk/cards/factory/monthly/m13_november_monthlies.coffee
Cards.Neutral.AzureHornShaman	FX.Cards.Neutral.AzureHornShaman	app/sdk/cards/factory/core/neutral.coffee
Cards.Neutral.Bastion	FX.Cards.Neutral.Bastion	app/sdk/cards/factory/monthly/m8_rexx.coffee
Cards.Neutral.Beastmaster	FX.Cards.Neutral.Chakkram	app/sdk/cards/factory/shimzar/neutral.coffee
Cards.Neutral.BigRush	FX.Cards.Neutral.FirstSwordofAkrane	app/sdk/cards/factory/coreshatter/neutral.coffee
Cards.Neutral.BigScarzig	FX.Cards.Neutral.WhistlingBlade	app/sdk/cards/factory/coreshatter/neutral.coffee
Cards.Neutral.BiggestGiantGolem	FX.Cards.Neutral.WhistlingBlade	app/sdk/cards/factory/coreshatter/neutral.coffee
Cards.Neutral.BlackLocust	FX.Cards.Neutral.BlackLocust	app/sdk/cards/factory/monthly/m1_movement.coffee
Cards.Neutral.BlackSandBurrower	FX.Cards.Neutral.BlackSandBurrower	app/sdk/cards/factory/core/neutral.coffee
Cards.Neutral.BlisteringSkorn	FX.Cards.Neutral.BlisteringSkorn	app/sdk/cards/factory/monthly/m10_general_damage.coffee
Cards.Neutral.BloodTaura	FX.Cards.Neutral.BloodTaura	app/sdk/cards/factory/monthly/m10_general_damage.coffee
Cards.Neutral.Bloodletter	FX.Cards.Neutral.Bloodletter	app/sdk/cards/factory/core/neutral.coffee
Cards.Neutral.BloodshardGolem	FX.Cards.Neutral.BloodshardGolem	app/sdk/cards/factory/core/neutral.coffee
Cards.Neutral.BloodtearAlchemist	FX.Cards.Neutral.BloodtearAlchemist	app/sdk/cards/factory/core/neutral.coffee
Cards.Neutral.BlueConjurer	FX.Cards.Neutral.AzureHornShaman	app/sdk/cards/factory/unity/neutral.coffee
Cards.Neutral.BlueblackProngbok	FX.Cards.Neutral.Feralu	app/sdk/cards/factory/coreshatter/neutral.coffee
Cards.Neutral.BluetipScorpion	FX.Cards.Neutral.BluetipScorpion	app/sdk/cards/factory/core/neutral.coffee
Cards.Neutral.Bonereaper	FX.Cards.Neutral.Bonereaper	app/sdk/cards/factory/monthly/m5_provoke.coffee
Cards.Neutral.BoulderBreacher	FX.Cards.Neutral.BoulderBreacher	app/sdk/cards/factory/unity/neutral.coffee
Cards.Neutral.BrightmossGolem	FX.Cards.Neutral.BrightmossGolem	app/sdk/cards/factory/core/neutral.coffee
Cards.Neutral.Calculator	FX.Cards.Neutral.EXun	app/sdk/cards/factory/shimzar/neutral.coffee
Cards.Neutral.CapriciousMarauder	FX.Cards.Neutral.BloodTaura	app/sdk/cards/factory/wartech/neutral.coffee
Cards.Neutral.Carcynus	FX.Cards.Neutral.EXun	app/sdk/cards/factory/firstwatch/neutral.coffee
Cards.Neutral.Celebrant	FX.Cards.Neutral.BloodtearAlchemist	app/sdk/cards/factory/unity/neutral.coffee
Cards.Neutral.Chakkram	FX.Cards.Neutral.Chakkram	app/sdk/cards/factory/monthly/m10_general_damage.coffee
Cards.Neutral.ChaosElemental	FX.Cards.Neutral.ChaosElemental	app/sdk/cards/factory/core/neutral.coffee
Cards.Neutral.CoiledCrawler	FX.Cards.Neutral.CoiledCrawler	app/sdk/cards/factory/core/neutral.coffee
Cards.Neutral.CrimsonOculus	FX.Cards.Neutral.CrimsonOculus	app/sdk/cards/factory/core/neutral.coffee
Cards.Neutral.Crossbones	FX.Cards.Neutral.Crossbones	app/sdk/cards/factory/core/neutral.coffee
Cards.Neutral.Cryptographer	FX.Cards.Neutral.AlcuinLoremaster	app/sdk/cards/factory/bloodstorm/neutral.coffee
Cards.Neutral.DaggerKiri	FX.Cards.Neutral.DaggerKiri	app/sdk/cards/factory/core/neutral.coffee
Cards.Neutral.DagonaFish	FX.Cards.Neutral.DagonaFish	app/sdk/cards/factory/firstwatch/neutral.coffee
Cards.Neutral.DancingBlades	FX.Cards.Neutral.DancingBlades	app/sdk/cards/factory/core/neutral.coffee
Cards.Neutral.DarkNemesis	FX.Cards.Neutral.DarkNemesis	app/sdk/cards/factory/core/neutral.coffee
Cards.Neutral.DayWatcher	FX.Cards.Neutral.DayWatcher	app/sdk/cards/factory/monthly/m12_october_monthlies.coffee
Cards.Neutral.DeathBlighter	FX.Cards.Neutral.DeathBlighter	app/sdk/cards/factory/core/neutral.coffee
Cards.Neutral.Deceptibot	FX.Cards.Neutral.EXun	app/sdk/cards/factory/wartech/neutral.coffee
Cards.Neutral.Decimus	FX.Cards.Neutral.Decimus	app/sdk/cards/factory/monthly/m13_november_monthlies.coffee
Cards.Neutral.DiamondGolem	FX.Cards.Neutral.DiamondGolem	app/sdk/cards/factory/monthly/m8_rexx.coffee
Cards.Neutral.Dilotas	FX.Cards.Neutral.Dilotas	app/sdk/cards/factory/core/neutral.coffee
Cards.Neutral.DilotasTombstone	FX.Cards.Neutral.DilotasTombstone	app/sdk/cards/factory/core/neutral.coffee
Cards.Neutral.Doxx	FX.Cards.Neutral.Spelljammer	app/sdk/cards/factory/coreshatter/neutral.coffee
Cards.Neutral.DragoneboneGolem	FX.Cards.Neutral.DragoneboneGolem	app/sdk/cards/factory/core/neutral.coffee
Cards.Neutral.Dreamgazer	FX.Cards.Neutral.Dreamgazer	app/sdk/cards/factory/monthly/m4_replace.coffee
Cards.Neutral.Duplicator	FX.Cards.Neutral.Mindwarper	app/sdk/cards/factory/unity/neutral.coffee
Cards.Neutral.DuplicatorShuffler	FX.Cards.Neutral.ProphetWhitePalm	app/sdk/cards/factory/coreshatter/neutral.coffee
Cards.Neutral.DustWailer	FX.Cards.Neutral.DustWailer	app/sdk/cards/factory/monthly/m12_october_monthlies.coffee
Cards.Neutral.EMP	FX.Cards.Neutral.EMP	app/sdk/cards/factory/unity/neutral.coffee
Cards.Neutral.EXun	FX.Cards.Neutral.EXun	app/sdk/cards/factory/monthly/m6_forcefield.coffee
Cards.Neutral.Eclipse	FX.Cards.Neutral.Eclipse	app/sdk/cards/factory/core/neutral.coffee
Cards.Neutral.Elkowl	FX.Cards.Neutral.Bonereaper	app/sdk/cards/factory/monthly/m11_penny_arcade.coffee
Cards.Neutral.Emberwyrm	FX.Cards.Neutral.Unseven	app/sdk/cards/factory/firstwatch/neutral.coffee
Cards.Neutral.EmeraldRejuvenator	FX.Cards.Neutral.EmeraldRejuvenator	app/sdk/cards/factory/core/neutral.coffee
Cards.Neutral.Envybaer	FX.Cards.Neutral.Envybaer	app/sdk/cards/factory/monthly/m9_streamers.coffee
Cards.Neutral.EphemeralShroud	FX.Cards.Neutral.EphemeralShroud	app/sdk/cards/factory/core/neutral.coffee
Cards.Neutral.Fatesealer	FX.Cards.Neutral.Fatesealer	app/sdk/cards/factory/misc/gauntlet_specials.coffee
Cards.Neutral.Feralu	FX.Cards.Neutral.Feralu	app/sdk/cards/factory/unity/neutral.coffee
Cards.Neutral.FidgetSpinner	FX.Cards.Neutral.Moebius	app/sdk/cards/factory/wartech/neutral.coffee
Cards.Neutral.FireSpitter	FX.Cards.Neutral.FireSpitter	app/sdk/cards/factory/core/neutral.coffee
Cards.Neutral.Firestarter	FX.Cards.Neutral.Firestarter	app/sdk/cards/factory/monthly/m2_reactive.coffee
Cards.Neutral.FirstSwordofAkrane	FX.Cards.Neutral.FirstSwordofAkrane	app/sdk/cards/factory/core/neutral.coffee
Cards.Neutral.FlameWing	FX.Cards.Neutral.FlameWing	app/sdk/cards/factory/core/neutral.coffee
Cards.Neutral.FlamebloodWarlock	FX.Cards.Neutral.FlamebloodWarlock	app/sdk/cards/factory/core/neutral.coffee
Cards.Neutral.Fog	FX.Cards.Neutral.Fog	app/sdk/cards/factory/shimzar/neutral.coffee
Cards.Neutral.Fortuneshaper	FX.Cards.Neutral.Fortuneshaper	app/sdk/cards/factory/misc/gauntlet_specials.coffee
Cards.Neutral.FrizzlingMystic	FX.Cards.Neutral.AstralCrusader	app/sdk/cards/factory/coreshatter/neutral.coffee
Cards.Neutral.FrostboneNaga	FX.Cards.Neutral.FrostboneNaga	app/sdk/cards/factory/core/neutral.coffee
Cards.Neutral.Futureshaker	FX.Cards.Neutral.Futureshaker	app/sdk/cards/factory/misc/gauntlet_specials.coffee
Cards.Neutral.Gambler	FX.Cards.Neutral.Gambler	app/sdk/cards/factory/firstwatch/neutral.coffee
Cards.Neutral.GhostLynx	FX.Cards.Neutral.GhostLynx	app/sdk/cards/factory/monthly/m1_movement.coffee
Cards.Neutral.Ghoulie	FX.Cards.Neutral.Necroseer	app/sdk/cards/factory/unity/neutral.coffee
Cards.Neutral.Gnasher	FX.Cards.Neutral.Bonereaper	app/sdk/cards/factory/shimzar/neutral.coffee
Cards.Neutral.GoldenJusticar	FX.Cards.Neutral.GoldenJusticar	app/sdk/cards/factory/monthly/m7_warmasters.coffee
Cards.Neutral.GoldenMantella	FX.Cards.Neutral.GoldenJusticar	app/sdk/cards/factory/shimzar/neutral.coffee
Cards.Neutral.GolemMetallurgist	FX.Cards.Neutral.GolemMetallurgist	app/sdk/cards/factory/core/neutral.coffee
Cards.Neutral.GolemVanquisher	FX.Cards.Neutral.GolemVanquisher	app/sdk/cards/factory/core/neutral.coffee
Cards.Neutral.Graboctopus	FX.Cards.Neutral.Paddo	app/sdk/cards/factory/coreshatter/neutral.coffee
Cards.Neutral.Grailmaster	FX.Cards.Neutral.Grailmaster	app/sdk/cards/factory/monthly/m2_reactive.coffee
Cards.Neutral.Grimes	FX.Cards.Neutral.Grincher	app/sdk/cards/factory/unity/neutral.coffee
Cards.Neutral.Grincher	FX.Cards.Neutral.Grincher	app/sdk/cards/factory/monthly/m9_streamers.coffee
Cards.Neutral.GroveLion	FX.Cards.Neutral.BlisteringSkorn	app/sdk/cards/factory/monthly/m11_penny_arcade.coffee
Cards.Neutral.HailstoneGolem	FX.Cards.Neutral.HailstoneGolem	app/sdk/cards/factory/core/neutral.coffee
Cards.Neutral.HailstoneHowler	FX.Cards.Neutral.Fireblazer	app/sdk/cards/factory/core/neutral.coffee
Cards.Neutral.HankHart	FX.Cards.Neutral.HankHart	app/sdk/cards/factory/core/neutral.coffee
Cards.Neutral.HealingMystic	FX.Cards.Neutral.HealingMystic	app/sdk/cards/factory/core/neutral.coffee
Cards.Neutral.HollowGrovekeeper	FX.Cards.Neutral.HollowGrovekeeper	app/sdk/cards/factory/monthly/m5_provoke.coffee
Cards.Neutral.Hsuku	FX.Cards.Neutral.ArchonSpellbinder	app/sdk/cards/factory/coreshatter/neutral.coffee
Cards.Neutral.Hydrax	FX.Cards.Neutral.BlisteringSkorn	app/sdk/cards/factory/shimzar/neutral.coffee
Cards.Neutral.ImperviousGiago	FX.Cards.Neutral.Bonereaper	app/sdk/cards/factory/wartech/neutral.coffee
Cards.Neutral.IncindyDindy	FX.Cards.Neutral.TheScientist	app/sdk/cards/factory/coreshatter/neutral.coffee
Cards.Neutral.InquisitorKron	FX.Cards.Neutral.WhiteWidow	app/sdk/cards/factory/shimzar/neutral.coffee
Cards.Neutral.Ion	FX.Cards.Neutral.PandoraMinionZap	app/sdk/cards/factory/shimzar/neutral.coffee
Cards.Neutral.Ironclad	FX.Cards.Neutral.Ironclad	app/sdk/cards/factory/monthly/m13_november_monthlies.coffee
Cards.Neutral.JaxTruesight	FX.Cards.Neutral.JaxTruesight	app/sdk/cards/factory/core/neutral.coffee
Cards.Neutral.Jaxi	FX.Cards.Neutral.Jaxi	app/sdk/cards/factory/monthly/m2_reactive.coffee
Cards.Neutral.KeeperOfTheVale	FX.Cards.Neutral.KeeperOfTheVale	app/sdk/cards/factory/monthly/m3_opening_gambit_buff.coffee
Cards.Neutral.Khymera	FX.Cards.Neutral.Khymera	app/sdk/cards/factory/monthly/m2_reactive.coffee
Cards.Neutral.Koi	FX.Cards.Neutral.Spelljammer	app/sdk/cards/factory/shimzar/neutral.coffee
Cards.Neutral.KomodoCharger	FX.Cards.Neutral.KomodoCharger	app/sdk/cards/factory/core/neutral.coffee
Cards.Neutral.KomodoHunter	FX.Cards.Neutral.AstralCrusader	app/sdk/cards/factory/firstwatch/neutral.coffee
Cards.Neutral.LadyLocke	FX.Cards.Neutral.LadyLocke	app/sdk/cards/factory/core/neutral.coffee
Cards.Neutral.Letigress	FX.Cards.Neutral.Letigress	app/sdk/cards/factory/firstwatch/neutral.coffee
Cards.Neutral.Lightbender	FX.Cards.Neutral.Lightbender	app/sdk/cards/factory/core/neutral.coffee
Cards.Neutral.LightningBeetle	FX.Cards.Neutral.LightningBeetle	app/sdk/cards/factory/core/neutral.coffee
Cards.Neutral.LuxIgnis	FX.Cards.Neutral.LuxIgnis	app/sdk/cards/factory/core/neutral.coffee
Cards.Neutral.Magesworn	FX.Cards.Neutral.Magesworn	app/sdk/cards/factory/firstwatch/neutral.coffee
Cards.Neutral.Manaforger	FX.Cards.Neutral.Manaforger	app/sdk/cards/factory/core/neutral.coffee
Cards.Neutral.MatterShaper	FX.Cards.Neutral.EXun	app/sdk/cards/factory/firstwatch/neutral.coffee
Cards.Neutral.Maw	FX.Cards.Neutral.Maw	app/sdk/cards/factory/core/neutral.coffee
Cards.Neutral.Mechaz0r	FX.Cards.Neutral.Mechaz0r	app/sdk/cards/factory/core/neutral.coffee
Cards.Neutral.Mechaz0rCannon	FX.Cards.Neutral.Mechaz0rCannon	app/sdk/cards/factory/core/neutral.coffee
Cards.Neutral.Mechaz0rChassis	FX.Cards.Neutral.Mechaz0rChassis	app/sdk/cards/factory/core/neutral.coffee
Cards.Neutral.Mechaz0rHelm	FX.Cards.Neutral.Mechaz0rHelm	app/sdk/cards/factory/core/neutral.coffee
Cards.Neutral.Mechaz0rSword	FX.Cards.Neutral.Mechaz0rSword	app/sdk/cards/factory/core/neutral.coffee
Cards.Neutral.Mechaz0rWings	FX.Cards.Neutral.Mechaz0rWings	app/sdk/cards/factory/core/neutral.coffee
Cards.Neutral.Meltdown	FX.Cards.Neutral.DarkNemesis	app/sdk/cards/factory/bloodstorm/neutral.coffee
Cards.Neutral.Metaltooth	FX.Cards.Neutral.GhostLynx	app/sdk/cards/factory/wartech/neutral.coffee
Cards.Neutral.Mindwarper	FX.Cards.Neutral.Mindwarper	app/sdk/cards/factory/core/neutral.coffee
Cards.Neutral.MiniJax	FX.Cards.Neutral.MiniJax	app/sdk/cards/factory/core/neutral.coffee
Cards.Neutral.MirkbloodDevourer	FX.Cards.Neutral.MirkbloodDevourer	app/sdk/cards/factory/core/neutral.coffee
Cards.Neutral.Moebius	FX.Cards.Neutral.Moebius	app/sdk/cards/factory/core/neutral.coffee
Cards.Neutral.Mogwai	FX.Cards.Neutral.Mogwai	app/sdk/cards/factory/monthly/m1_movement.coffee
Cards.Neutral.MoonlightSorcerer	FX.Cards.Neutral.Necroseer	app/sdk/cards/factory/coreshatter/neutral.coffee
Cards.Neutral.Necroseer	FX.Cards.Neutral.Necroseer	app/sdk/cards/factory/core/neutral.coffee
Cards.Neutral.NightWatcher	FX.Cards.Neutral.NightWatcher	app/sdk/cards/factory/monthly/m12_october_monthlies.coffee
Cards.Neutral.Nip	FX.Cards.Neutral.Nip	app/sdk/cards/factory/shimzar/neutral.coffee
Cards.Neutral.Oni	FX.Cards.Neutral.Oni	app/sdk/cards/factory/shimzar/neutral.coffee
Cards.Neutral.OwlbeastSage	FX.Cards.Neutral.OwlbeastSage	app/sdk/cards/factory/core/neutral.coffee
Cards.Neutral.Paddo	FX.Cards.Neutral.Paddo	app/sdk/cards/factory/core/neutral.coffee
Cards.Neutral.Pandora	FX.Cards.Neutral.Pandora	app/sdk/cards/factory/core/neutral.coffee
Cards.Neutral.PandoraMinion1	FX.Cards.Neutral.PandoraMinionCloud	app/sdk/cards/factory/core/neutral.coffee
Cards.Neutral.PandoraMinion2	FX.Cards.Neutral.PandoraMinionBlaze	app/sdk/cards/factory/core/neutral.coffee
Cards.Neutral.PandoraMinion3	FX.Cards.Neutral.PandoraMinionFlash	app/sdk/cards/factory/core/neutral.coffee
Cards.Neutral.PandoraMinion4	FX.Cards.Neutral.PandoraMinionZap	app/sdk/cards/factory/core/neutral.coffee
Cards.Neutral.PandoraMinion5	FX.Cards.Neutral.PandoraMinionSinker	app/sdk/cards/factory/core/neutral.coffee
Cards.Neutral.PartyAnimal1	FX.Cards.Neutral.Spelljammer	app/sdk/cards/factory/firstwatch/neutral.coffee
Cards.Neutral.PartyAnimal2	FX.Cards.Neutral.PlanarScout	app/sdk/cards/factory/firstwatch/neutral.coffee
Cards.Neutral.PartyAnimal3	FX.Cards.Neutral.Icy	app/sdk/cards/factory/firstwatch/neutral.coffee
Cards.Neutral.PartyAnimal4	FX.Cards.Neutral.VineEntangler	app/sdk/cards/factory/firstwatch/neutral.coffee
Cards.Neutral.PennyPacker	FX.Cards.Neutral.GolemVanquisher	app/sdk/cards/factory/coreshatter/neutral.coffee
Cards.Neutral.PhaseHound	FX.Cards.Neutral.PhaseHound	app/sdk/cards/factory/core/neutral.coffee
Cards.Neutral.PiercingMantis	FX.Cards.Neutral.PiercingMantis	app/sdk/cards/factory/core/neutral.coffee
Cards.Neutral.PlanarScout	FX.Cards.Neutral.PlanarScout	app/sdk/cards/factory/core/neutral.coffee
Cards.Neutral.PrimusFist	FX.Cards.Neutral.PrimusFist	app/sdk/cards/factory/core/neutral.coffee
Cards.Neutral.PrimusShieldmaster	FX.Cards.Neutral.PrimusShieldmaster	app/sdk/cards/factory/core/neutral.coffee
Cards.Neutral.PrismaticIllusionist	FX.Cards.Neutral.PrismaticIllusionist	app/sdk/cards/factory/core/neutral.coffee
Cards.Neutral.Prisoner1	FX.Cards.Neutral.WhiteWidow	app/sdk/cards/factory/shimzar/neutral.coffee
Cards.Neutral.Prisoner2	FX.Cards.Neutral.WhiteWidow	app/sdk/cards/factory/shimzar/neutral.coffee
Cards.Neutral.Prisoner3	FX.Cards.Neutral.WhiteWidow	app/sdk/cards/factory/shimzar/neutral.coffee
Cards.Neutral.Prisoner5	FX.Cards.Neutral.WhiteWidow	app/sdk/cards/factory/shimzar/neutral.coffee
Cards.Neutral.Prisoner6	FX.Cards.Neutral.WhiteWidow	app/sdk/cards/factory/shimzar/neutral.coffee
Cards.Neutral.ProjectOmega	FX.Cards.Faction5.Kin	app/sdk/cards/factory/wartech/neutral.coffee
Cards.Neutral.ProphetWhitePalm	FX.Cards.Neutral.ProphetWhitePalm	app/sdk/cards/factory/monthly/m3_opening_gambit_buff.coffee
Cards.Neutral.Purgatos	FX.Cards.Neutral.Purgatos	app/sdk/cards/factory/core/neutral.coffee
Cards.Neutral.PutridMindflayer	FX.Cards.Neutral.PutridMindflayer	app/sdk/cards/factory/core/neutral.coffee
Cards.Neutral.Qorrhlmaa	FX.Cards.Neutral.TheScientist	app/sdk/cards/factory/wartech/neutral.coffee
Cards.Neutral.Quahog	FX.Cards.Neutral.Quahog	app/sdk/cards/factory/firstwatch/neutral.coffee
Cards.Neutral.QuartermasterGauj	FX.Cards.Neutral.QuartermasterGauj	app/sdk/cards/factory/monthly/m12_october_monthlies.coffee
Cards.Neutral.Rawr	FX.Cards.Neutral.EXun	app/sdk/cards/factory/shimzar/neutral.coffee
Cards.Neutral.RazorcragGolem	FX.Cards.Neutral.RazorcragGolem	app/sdk/cards/factory/firstwatch/neutral.coffee
Cards.Neutral.Recombobulus	FX.Cards.Neutral.BloodtearAlchemist	app/sdk/cards/factory/wartech/neutral.coffee
Cards.Neutral.RedSynja	FX.Cards.Neutral.RedSynja	app/sdk/cards/factory/core/neutral.coffee
Cards.Neutral.RedsteelMinos	FX.Cards.Neutral.ChaosElemental	app/sdk/cards/factory/wartech/neutral.coffee
Cards.Neutral.Reliquarian	FX.Cards.Faction2.StormKage	app/sdk/cards/factory/wartech/neutral.coffee
Cards.Neutral.Replicant	FX.Cards.Neutral.PandoraMinionZap	app/sdk/cards/factory/wartech/neutral.coffee
Cards.Neutral.RepulsionBeast	FX.Cards.Neutral.RepulsionBeast	app/sdk/cards/factory/core/neutral.coffee
Cards.Neutral.RescueRX	FX.Cards.Neutral.Mindwarper	app/sdk/cards/factory/wartech/neutral.coffee
Cards.Neutral.RescueRXBuilding	FX.Cards.Neutral.Bastion	app/sdk/cards/factory/wartech/neutral.coffee
Cards.Neutral.RockPulverizer	FX.Cards.Neutral.RockPulverizer	app/sdk/cards/factory/core/neutral.coffee
Cards.Neutral.RogueWarden	FX.Cards.Neutral.RogueWarden	app/sdk/cards/factory/core/neutral.coffee
Cards.Neutral.Rok	FX.Cards.Neutral.DiamondGolem	app/sdk/cards/factory/shimzar/neutral.coffee
Cards.Neutral.Rokadoptera	FX.Cards.Neutral.DiamondGolem	app/sdk/cards/factory/firstwatch/neutral.coffee
Cards.Neutral.Rook	FX.Cards.Neutral.Rook	app/sdk/cards/factory/core/neutral.coffee
Cards.Neutral.RubyRifter	FX.Cards.Neutral.RubyRifter	app/sdk/cards/factory/monthly/m10_general_damage.coffee
Cards.Neutral.SaberspineTiger	FX.Cards.Neutral.SaberspineTiger	app/sdk/cards/factory/core/neutral.coffee
Cards.Neutral.Sai	FX.Cards.Neutral.Sai	app/sdk/cards/factory/shimzar/neutral.coffee
Cards.Neutral.Sanguinar	FX.Cards.Neutral.Necroseer	app/sdk/cards/factory/bloodstorm/neutral.coffee
Cards.Neutral.SapphireSeer	FX.Cards.Neutral.SapphireSeer	app/sdk/cards/factory/monthly/m6_forcefield.coffee
Cards.Neutral.SarlacTheEternal	FX.Cards.Neutral.SarlacTheEternal	app/sdk/cards/factory/core/neutral.coffee
Cards.Neutral.Scarzig	FX.Cards.Neutral.PlanarScout	app/sdk/cards/factory/coreshatter/neutral.coffee
Cards.Neutral.Serpenti	FX.Cards.Neutral.Serpenti	app/sdk/cards/factory/core/neutral.coffee
Cards.Neutral.Shiro	FX.Cards.Neutral.Shiro	app/sdk/cards/factory/monthly/m9_streamers.coffee
Cards.Neutral.SilhoutteTracer	FX.Cards.Neutral.SilhoutteTracer	app/sdk/cards/factory/core/neutral.coffee
Cards.Neutral.Silver	FX.Cards.Neutral.RubyRifter	app/sdk/cards/factory/wartech/neutral.coffee
Cards.Neutral.Silverbeak	FX.Cards.Neutral.Unseven	app/sdk/cards/factory/shimzar/neutral.coffee
Cards.Neutral.SilvertongueCorsair	FX.Cards.Neutral.SilvertongueCorsair	app/sdk/cards/factory/core/neutral.coffee
Cards.Neutral.Singleton	FX.Cards.Neutral.Purgatos	app/sdk/cards/factory/coreshatter/neutral.coffee
Cards.Neutral.SinisterSilhouette	FX.Cards.Neutral.PlanarScout	app/sdk/cards/factory/firstwatch/neutral.coffee
Cards.Neutral.SkyrockGolem	FX.Cards.Neutral.SkyrockGolem	app/sdk/cards/factory/core/neutral.coffee
Cards.Neutral.Skywing	FX.Cards.Neutral.Skywing	app/sdk/cards/factory/monthly/m7_warmasters.coffee
Cards.Neutral.Soboro	FX.Cards.Neutral.EXun	app/sdk/cards/factory/shimzar/neutral.coffee
Cards.Neutral.Sojourner	FX.Cards.Neutral.Sojourner	app/sdk/cards/factory/core/neutral.coffee
Cards.Neutral.Sol	FX.Cards.Neutral.Sol	app/sdk/cards/factory/shimzar/neutral.coffee
Cards.Neutral.Songweaver	FX.Cards.Neutral.Songweaver	app/sdk/cards/factory/core/neutral.coffee
Cards.Neutral.Spelljammer	FX.Cards.Neutral.Spelljammer	app/sdk/cards/factory/core/neutral.coffee
Cards.Neutral.Spellspark	FX.Cards.Neutral.Spellspark	app/sdk/cards/factory/monthly/m2_reactive.coffee
Cards.Neutral.Sphynx	FX.Cards.Neutral.AstralCrusader	app/sdk/cards/factory/monthly/m11_penny_arcade.coffee
Cards.Neutral.SpottedDragonlark	FX.Cards.Neutral.SpottedDragonlark	app/sdk/cards/factory/core/neutral.coffee
Cards.Neutral.Spriggin	FX.Cards.Neutral.TwilightMage	app/sdk/cards/factory/firstwatch/neutral.coffee
Cards.Neutral.StormmetalGolem	FX.Cards.Neutral.StormmetalGolem	app/sdk/cards/factory/core/neutral.coffee
Cards.Neutral.SunElemental	FX.Cards.Neutral.SunElemental	app/sdk/cards/factory/monthly/m3_opening_gambit_buff.coffee
Cards.Neutral.SunSeer	FX.Cards.Neutral.SunSeer	app/sdk/cards/factory/core/neutral.coffee
Cards.Neutral.SunsetParagon	FX.Cards.Neutral.SunsetParagon	app/sdk/cards/factory/monthly/m6_forcefield.coffee
Cards.Neutral.SunsteelDefender	FX.Cards.Neutral.SunsteelDefender	app/sdk/cards/factory/monthly/m6_forcefield.coffee
Cards.Neutral.SuperDoxx	FX.Cards.Neutral.EXun	app/sdk/cards/factory/coreshatter/neutral.coffee
Cards.Neutral.SwornAvenger	FX.Cards.Neutral.SwornAvenger	app/sdk/cards/factory/core/neutral.coffee
Cards.Neutral.SwornDefender	FX.Cards.Neutral.SwornDefender	app/sdk/cards/factory/core/neutral.coffee
Cards.Neutral.SwornSister	FX.Cards.Neutral.SwornSister	app/sdk/cards/factory/monthly/sisters.coffee
Cards.Neutral.SyvrelTheExile	FX.Cards.Neutral.SyvrelTheExile	app/sdk/cards/factory/core/neutral.coffee
Cards.Neutral.Tethermancer	FX.Cards.Neutral.Tethermancer	app/sdk/cards/factory/monthly/m5_provoke.coffee
Cards.Neutral.TheHighHand	FX.Cards.Neutral.TheHighHand	app/sdk/cards/factory/core/neutral.coffee
Cards.Neutral.TheScientist	FX.Cards.Neutral.TheScientist	app/sdk/cards/factory/monthly/m9_streamers.coffee
Cards.Neutral.Theobule	FX.Cards.Neutral.Shuffler	app/sdk/cards/factory/firstwatch/neutral.coffee
Cards.Neutral.ThornNeedler	FX.Cards.Neutral.ThornNeedler	app/sdk/cards/factory/core/neutral.coffee
Cards.Neutral.Thunderhorn	FX.Cards.Neutral.Unseven	app/sdk/cards/factory/firstwatch/neutral.coffee
Cards.Neutral.TigerCub	FX.Cards.Neutral.GhostLynx	app/sdk/cards/factory/firstwatch/neutral.coffee
Cards.Neutral.Timekeeper	FX.Cards.Neutral.Moebius	app/sdk/cards/factory/wartech/neutral.coffee
Cards.Neutral.TrinityWing	FX.Cards.Neutral.FlameWing	app/sdk/cards/factory/unity/neutral.coffee
Cards.Neutral.TwilightMage	FX.Cards.Neutral.TwilightMage	app/sdk/cards/factory/core/neutral.coffee
Cards.Neutral.Ubo	FX.Cards.Neutral.Ubo	app/sdk/cards/factory/shimzar/neutral.coffee
Cards.Neutral.Unseven	FX.Cards.Neutral.Unseven	app/sdk/cards/factory/monthly/m7_warmasters.coffee
Cards.Neutral.ValeHunter	FX.Cards.Neutral.ValeHunter	app/sdk/cards/factory/core/neutral.coffee
Cards.Neutral.ValueMcDownside	FX.Cards.Neutral.AlterRexx	app/sdk/cards/factory/coreshatter/neutral.coffee
Cards.Neutral.VenomToth	FX.Cards.Neutral.VenomToth	app/sdk/cards/factory/core/neutral.coffee
Cards.Neutral.VineEntangler	FX.Cards.Neutral.VineEntangler	app/sdk/cards/factory/core/neutral.coffee
Cards.Neutral.VoidExploder	FX.Cards.Neutral.Chakkram	app/sdk/cards/factory/coreshatter/neutral.coffee
Cards.Neutral.VoidHunter	FX.Cards.Neutral.VoidHunter	app/sdk/cards/factory/core/neutral.coffee
Cards.Neutral.WarTalon	FX.Cards.Neutral.WarTalon	app/sdk/cards/factory/monthly/m5_provoke.coffee
Cards.Neutral.WhistlingBlade	FX.Cards.Neutral.WhistlingBlade	app/sdk/cards/factory/core/neutral.coffee
Cards.Neutral.WhiteWidow	FX.Cards.Neutral.WhiteWidow	app/sdk/cards/factory/monthly/m4_replace.coffee
Cards.Neutral.WildTahr	FX.Cards.Neutral.WildTahr	app/sdk/cards/factory/firstwatch/neutral.coffee
Cards.Neutral.WindRunner	FX.Cards.Neutral.WindRunner	app/sdk/cards/factory/monthly/m1_movement.coffee
Cards.Neutral.WindStopper	FX.Cards.Neutral.WindStopper	app/sdk/cards/factory/core/neutral.coffee
Cards.Neutral.WingsOfParadise	FX.Cards.Neutral.WingsOfParadise	app/sdk/cards/factory/monthly/m4_replace.coffee
Cards.Neutral.WoodWen	FX.Cards.Neutral.WhiteWidow	app/sdk/cards/factory/monthly/m11_penny_arcade.coffee
Cards.Neutral.Yun	FX.Cards.Neutral.Yun	app/sdk/cards/factory/shimzar/neutral.coffee
Cards.Neutral.Z0r	FX.Cards.Neutral.Mechaz0rHelm	app/sdk/cards/factory/shimzar/neutral.coffee
Cards.Neutral.ZenRui	FX.Cards.Neutral.ZenRui	app/sdk/cards/factory/core/neutral.coffee
Cards.Neutral.Zukong	FX.Cards.Neutral.EXun	app/sdk/cards/factory/shimzar/neutral.coffee
Cards.Neutral.ZuraelTheLifegiver	FX.Cards.Neutral.ZuraelTheLifegiver	app/sdk/cards/factory/core/neutral.coffee
Cards.Neutral.Zyx	FX.Cards.Neutral.Zyx	app/sdk/cards/factory/monthly/m13_november_monthlies.coffee
Cards.Spell.AbhorrentUnbirth	FX.Cards.Spell.AbhorrentUnbirth	app/sdk/cards/factory/wartech/faction4.coffee
Cards.Spell.AbyssalScar	FX.Cards.Spell.AbyssalScar	app/sdk/cards/factory/core/faction4.coffee
Cards.Spell.AbyssianStrength	FX.Cards.Spell.AbyssianStrength	app/sdk/cards/factory/core/faction4.coffee
Cards.Spell.AegisBarrier	FX.Cards.Spell.AegisBarrier	app/sdk/cards/factory/core/faction1.coffee
Cards.Spell.AerialRift	FX.Cards.Spell.AerialRift	app/sdk/cards/factory/core/faction1.coffee
Cards.Spell.Afterblaze	FX.Cards.Spell.WarSurge	app/sdk/cards/factory/shimzar/faction1.coffee
Cards.Spell.Afterglow	FX.Cards.Spell.Afterglow	app/sdk/cards/factory/core/faction1.coffee
Cards.Spell.AlteredBeast	FX.Cards.Spell.AlteredBeast	app/sdk/cards/factory/shimzar/faction6.coffee
Cards.Spell.Amplification	FX.Cards.Spell.Amplification	app/sdk/cards/factory/core/faction5.coffee
Cards.Spell.AncestralDivination	FX.Cards.Spell.AncestralDivination	app/sdk/cards/factory/core/faction2.coffee
Cards.Spell.AperionsClaim	FX.Cards.Spell.AperionsClaim	app/sdk/cards/factory/firstwatch/faction1.coffee
Cards.Spell.AphoticDrain	FX.Cards.Spell.CurseOfAgony	app/sdk/cards/factory/bloodstorm/faction4.coffee
Cards.Spell.ApplyModifiers	FX.Cards.Spell.ApplyModifiers	app/sdk/cards/factory/misc/generic.coffee
Cards.Spell.ArcaneHeart	FX.Cards.Spell.ArcaneHeart	app/sdk/cards/factory/core/faction2.coffee
Cards.Spell.AridUnmaking	FX.Cards.Spell.AridUnmaking	app/sdk/cards/factory/firstwatch/faction3.coffee
Cards.Spell.ArtifactDefiler	FX.Cards.Spell.ArtifactDefiler	app/sdk/cards/factory/core/faction2.coffee
Cards.Spell.AspectOfBear	FX.Cards.Spell.AspectOfBear	app/sdk/cards/factory/wartech/faction6.coffee
Cards.Spell.AspectOfIdentity	FX.Cards.Spell.AspectOfEgo	app/sdk/cards/factory/coreshatter/faction6.coffee
Cards.Spell.AspectOfTheDrake	FX.Cards.Spell.AspectOfTheDrake	app/sdk/cards/factory/core/faction6.coffee
Cards.Spell.AspectOfTheMountains	FX.Cards.Spell.AspectOfTheDrake	app/sdk/cards/factory/core/faction6.coffee
Cards.Spell.AspectOfTheWolf	FX.Cards.Spell.AspectOfTheWolf	app/sdk/cards/factory/core/faction6.coffee
Cards.Spell.AssassinationProtocol	FX.Cards.Spell.Assassination	app/sdk/cards/factory/wartech/faction2.coffee
Cards.Spell.AstralFlood	FX.Cards.Spell.AstralFlood	app/sdk/cards/factory/shimzar/faction3.coffee
Cards.Spell.AstralPhasing	FX.Cards.Spell.AstralPhasing	app/sdk/cards/factory/core/faction3.coffee
Cards.Spell.Auroraboros	FX.Cards.Spell.Auroraboros	app/sdk/cards/factory/wartech/faction6.coffee
Cards.Spell.AurorasTears	FX.Cards.Spell.AurorasTears	app/sdk/cards/factory/core/faction3.coffee
Cards.Spell.AurynNexus	FX.Cards.Spell.AurynNexus	app/sdk/cards/factory/core/faction1.coffee
Cards.Spell.Avalanche	FX.Cards.Spell.Avalanche	app/sdk/cards/factory/core/faction6.coffee
Cards.Spell.AzureSummoning	FX.Cards.Spell.AzureSummoning	app/sdk/cards/factory/firstwatch/faction3.coffee
Cards.Spell.Backstabbery	FX.Cards.Spell.ObscuringBlow	app/sdk/cards/factory/bloodstorm/faction2.coffee
Cards.Spell.Bamboozle	FX.Cards.Spell.Bamboozle	app/sdk/cards/factory/wartech/faction2.coffee
Cards.Spell.BeamShock	FX.Cards.Spell.BeamShock	app/sdk/cards/factory/core/faction1.coffee
Cards.Spell.Betrayal	FX.Cards.Spell.Betrayal	app/sdk/cards/factory/wartech/faction4.coffee
Cards.Spell.BigTime	FX.Cards.Spell.GargantuanGrowth	app/sdk/cards/factory/coreshatter/faction5.coffee
Cards.Spell.BlazingSpines	FX.Spell.FireTornado	app/sdk/cards/factory/core/faction6.coffee
Cards.Spell.BlindingSnowstorm	FX.Cards.Spell.BlindingSnowstorm	app/sdk/cards/factory/firstwatch/faction6.coffee
Cards.Spell.Blindscorch	FX.Cards.Spell.Blindscorch	app/sdk/cards/factory/core/faction3.coffee
Cards.Spell.Blink	FX.Cards.Spell.Blink	app/sdk/cards/factory/core/faction2.coffee
Cards.Spell.BloodOfAir	FX.Cards.Spell.BloodOfAir	app/sdk/cards/factory/unity/faction3.coffee
Cards.Spell.BloodRage	FX.Cards.Spell.BloodRage	app/sdk/cards/factory/firstwatch/faction5.coffee
Cards.Spell.Bombard	FX.Cards.Spell.Bombard	app/sdk/cards/factory/firstwatch/faction2.coffee
Cards.Spell.BoneSwarm	FX.Cards.Spell.BoneSwarm	app/sdk/cards/factory/core/faction3.coffee
Cards.Spell.BonechillBarrier	FX.Spell.FireTornado	app/sdk/cards/factory/core/faction6.coffee
Cards.Spell.BootyProjection	FX.Cards.Spell.SecondSelf	app/sdk/cards/factory/coreshatter/faction2.coffee
Cards.Spell.BoulderHurl	FX.Cards.Spell.BoulderHurl	app/sdk/cards/factory/firstwatch/neutral.coffee
Cards.Spell.BounceMinionSpawnEntity	FX.Cards.Spell.BounceMinionSpawnEntity	app/sdk/cards/factory/misc/generic.coffee
Cards.Spell.BoundedLifeforce	FX.Cards.Spell.BoundedLifeforce	app/sdk/cards/factory/core/faction5.coffee
Cards.Spell.BreathOfTheUnborn	FX.Cards.Spell.BreathOfTheUnborn	app/sdk/cards/factory/core/faction4.coffee
Cards.Spell.BrilliantPlume	FX.Cards.Spell.BrilliantPlume	app/sdk/cards/factory/coreshatter/neutral.coffee
Cards.Spell.BurdenOfKnowledge	FX.Cards.Spell.BurdenOfKnowledge	app/sdk/cards/factory/wartech/faction3.coffee
Cards.Spell.CallToArms	FX.Cards.Spell.CallToArms	app/sdk/cards/factory/wartech/faction1.coffee
Cards.Spell.CataclysmicFault	FX.Cards.Spell.CataclysmicFault	app/sdk/cards/factory/firstwatch/faction3.coffee
Cards.Spell.ChanneledBreath	FX.Cards.Spell.ChanneledBreath	app/sdk/cards/factory/firstwatch/faction1.coffee
Cards.Spell.ChargeIntoBattle	FX.Cards.Spell.Lionize	app/sdk/cards/factory/coreshatter/faction1.coffee
Cards.Spell.ChokingTendrils	FX.Cards.Spell.ChokingTendrils	app/sdk/cards/factory/firstwatch/faction4.coffee
Cards.Spell.ChromaticCold	FX.Cards.Spell.ChromaticCold	app/sdk/cards/factory/core/faction6.coffee
Cards.Spell.ChrysalisBloom	FX.Cards.Spell.ChrysalisBurst	app/sdk/cards/factory/core/faction5.coffee
Cards.Spell.CircleLife	FX.Cards.Spell.CircleLife	app/sdk/cards/factory/core/faction1.coffee
Cards.Spell.CircleOfDesiccation	FX.Cards.Spell.CircleOfDesiccation	app/sdk/cards/factory/shimzar/faction3.coffee
Cards.Spell.CloneSourceEntity	FX.Factions.Neutral.UnitSpawnFX	app/sdk/cards/factory/misc/generic.coffee
Cards.Spell.CloneSourceEntity2X	FX.Factions.Neutral.UnitSpawnFX	app/sdk/cards/factory/misc/generic.coffee
Cards.Spell.CloneSourceEntity3X	FX.Factions.Neutral.UnitSpawnFX	app/sdk/cards/factory/misc/generic.coffee
Cards.Spell.CloneSourceEntity4X	FX.Factions.Neutral.UnitSpawnFX	app/sdk/cards/factory/misc/generic.coffee
Cards.Spell.CloneSourceEntityNearbyGeneral	FX.Factions.Neutral.UnitSpawnFX	app/sdk/cards/factory/misc/generic.coffee
Cards.Spell.CloneSourceEntityNearbyGeneral2X	FX.Factions.Neutral.UnitSpawnFX	app/sdk/cards/factory/misc/generic.coffee
Cards.Spell.CloneTargetEntity	FX.Factions.Neutral.UnitSpawnFX	app/sdk/cards/factory/misc/generic.coffee
Cards.Spell.CobraStrike	FX.Cards.Spell.CobraStrike	app/sdk/cards/factory/bloodstorm/faction2.coffee
Cards.Spell.ConcealingShroud	FX.Cards.Spell.ElementalFury	app/sdk/cards/factory/bloodstorm/faction6.coffee
Cards.Spell.Congregation	FX.Cards.Spell.Congregation	app/sdk/cards/factory/firstwatch/faction1.coffee
Cards.Spell.ConsumingRebirth	FX.Cards.Spell.ConsumingRebirth	app/sdk/cards/factory/core/faction4.coffee
Cards.Spell.CorporealCadence	FX.Cards.Spell.CorporealCadence	app/sdk/cards/factory/firstwatch/faction4.coffee
Cards.Spell.CorpseCombustion	FX.Cards.Spell.CosmicFlesh	app/sdk/cards/factory/shimzar/faction3.coffee
Cards.Spell.CosmicFlesh	FX.Cards.Spell.CosmicFlesh	app/sdk/cards/factory/core/faction3.coffee
Cards.Spell.CreepingFrost	FX.Cards.Spell.Permafrost	app/sdk/cards/factory/coreshatter/faction6.coffee
Cards.Spell.CrimsonCoil	FX.Cards.Spell.CrimsonCoil	app/sdk/cards/factory/shimzar/faction2.coffee
Cards.Spell.Cryogenesis	FX.Cards.Spell.Cryogenesis	app/sdk/cards/factory/core/faction6.coffee
Cards.Spell.CrystallineReinforcement	FX.Cards.Spell.CrystalReinforce	app/sdk/cards/factory/wartech/faction6.coffee
Cards.Spell.CurseOfAgony	FX.Cards.Spell.CurseOfAgony	app/sdk/cards/factory/core/faction4.coffee
Cards.Spell.DaemonicLure	FX.Cards.Spell.DaemonicLure	app/sdk/cards/factory/core/faction4.coffee
Cards.Spell.DampeningWave	FX.Cards.Spell.DampeningWave	app/sdk/cards/factory/core/faction5.coffee
Cards.Spell.DanceOfDreams	FX.Cards.Spell.DanceOfDreams	app/sdk/cards/factory/core/faction5.coffee
Cards.Spell.DarkSacrifice	FX.Cards.Spell.DarkSacrifice	app/sdk/cards/factory/core/faction4.coffee
Cards.Spell.DarkSeed	FX.Cards.Spell.DarkSeed	app/sdk/cards/factory/core/faction4.coffee
Cards.Spell.DarkTransformation	FX.Cards.Spell.DarkTransformation	app/sdk/cards/factory/core/faction4.coffee
Cards.Spell.DauntlessAdvance	FX.Cards.Spell.DauntlessAdvance	app/sdk/cards/factory/wartech/faction1.coffee
Cards.Spell.DeathIncoming	FX.Cards.Spell.BloodEchoes	app/sdk/cards/factory/unity/faction4.coffee
Cards.Spell.DeathfireCrescendo	FX.Cards.Spell.DeathfireCrescendo	app/sdk/cards/factory/core/faction4.coffee
Cards.Spell.Deathmark	FX.Cards.Spell.Deathmark	app/sdk/cards/factory/wartech/faction4.coffee
Cards.Spell.DeathstrikeSeal	FX.Cards.Spell.DeathstrikeSeal	app/sdk/cards/factory/core/faction2.coffee
Cards.Spell.DebuffBBS	FX.Cards.Spell.Decension	app/sdk/cards/factory/core/faction3.coffee
Cards.Spell.Decimate	FX.Cards.Spell.Decimate	app/sdk/cards/factory/core/faction1.coffee
Cards.Spell.DejaVu	FX.Cards.Spell.Meditate	app/sdk/cards/factory/coreshatter/faction2.coffee
Cards.Spell.DeployMechaz0r	FX.Factions.Neutral.SpawnSpecialFX	app/sdk/cards/factory/misc/generic.coffee
Cards.Spell.DiretideFrenzy	FX.Cards.Spell.DiretideFrenzy	app/sdk/cards/factory/core/faction5.coffee
Cards.Spell.Dispel	FX.Cards.Spell.Dispel	app/sdk/cards/factory/misc/generic.coffee
Cards.Spell.DivineBond	FX.Cards.Spell.DivineBond	app/sdk/cards/factory/core/faction1.coffee
Cards.Spell.DivineSpark	FX.Cards.Spell.DivineSpark	app/sdk/cards/factory/bloodstorm/faction3.coffee
Cards.Spell.DivinestBonderest	FX.Cards.Spell.DivineLiturgy	app/sdk/cards/factory/coreshatter/faction1.coffee
Cards.Spell.Doom	FX.Cards.Spell.Doom	app/sdk/cards/factory/firstwatch/faction4.coffee
Cards.Spell.DoubleAttackAndHealth	FX.Cards.Spell.ApplyModifiers	app/sdk/cards/factory/misc/generic.coffee
Cards.Spell.DragonBreath	FX.Cards.Spell.LessonOfPower	app/sdk/cards/factory/unity/neutral.coffee
Cards.Spell.DragonGrace	FX.Cards.Spell.LessonOfWisdom	app/sdk/cards/factory/unity/neutral.coffee
Cards.Spell.DragonHeart	FX.Cards.Spell.LessonOfCourage	app/sdk/cards/factory/unity/neutral.coffee
Cards.Spell.DrainMorale	FX.Cards.Spell.SandTrap	app/sdk/cards/factory/core/faction3.coffee
Cards.Spell.DrainingWave	FX.Cards.Spell.DrainingWave	app/sdk/cards/factory/bloodstorm/faction1.coffee
Cards.Spell.DropLift	FX.Cards.Spell.DropLift	app/sdk/cards/factory/firstwatch/faction3.coffee
Cards.Spell.DunecasterFollowup	FX.Cards.Spell.ApplyModifiers	app/sdk/cards/factory/misc/generic.coffee
Cards.Spell.EarthSphere	FX.Cards.Spell.EarthSphere	app/sdk/cards/factory/core/faction5.coffee
Cards.Spell.EchoingShriek	FX.Cards.Spell.EchoingShriek	app/sdk/cards/factory/shimzar/faction4.coffee
Cards.Spell.EffulgentInfusion	FX.Cards.Spell.EffulgentInfusion	app/sdk/cards/factory/wartech/faction5.coffee
Cards.Spell.EggBBS	FX.Cards.Spell.EggBBS	app/sdk/cards/factory/core/faction5.coffee
Cards.Spell.EggGrenade	FX.Cards.Spell.Pupabomb	app/sdk/cards/factory/wartech/faction5.coffee
Cards.Spell.EggMorph	FX.Cards.Spell.EggMorph	app/sdk/cards/factory/core/faction5.coffee
Cards.Spell.EightGates	FX.Cards.Spell.EightGates	app/sdk/cards/factory/core/faction2.coffee
Cards.Spell.ElementalFury	FX.Cards.Spell.ElementalFury	app/sdk/cards/factory/core/faction6.coffee
Cards.Spell.EmbryoticInsight	FX.Cards.Spell.EmbryoticInsight	app/sdk/cards/factory/wartech/faction5.coffee
Cards.Spell.EndureTheBeastlands	FX.Cards.Spell.EndureTheBeastlands	app/sdk/cards/factory/firstwatch/faction5.coffee
Cards.Spell.Enfeeble	FX.Cards.Spell.Enfeeble	app/sdk/cards/factory/bloodstorm/faction6.coffee
Cards.Spell.Enslave	FX.Cards.Spell.Enslave	app/sdk/cards/factory/core/faction3.coffee
Cards.Spell.EnterThunderdome	FX.Cards.Spell.IceAge	app/sdk/cards/factory/coreshatter/faction6.coffee
Cards.Spell.EntropicDecay	FX.Cards.Spell.EntropicDecay	app/sdk/cards/factory/core/faction3.coffee
Cards.Spell.EntropicGaze	FX.Cards.Spell.EntropicGaze	app/sdk/cards/factory/bloodstorm/faction5.coffee
Cards.Spell.EqualityConstraint	FX.Cards.Spell.EqualityConstraint	app/sdk/cards/factory/wartech/faction3.coffee
Cards.Spell.EquipVetArtifacts	FX.Cards.Spell.AutarchsGifts	app/sdk/cards/factory/bloodstorm/faction3.coffee
Cards.Spell.EssenceSculpt	FX.Cards.Spell.EssenceSculpt	app/sdk/cards/factory/wartech/faction6.coffee
Cards.Spell.EtherealBlades	FX.Cards.Spell.EtherealBlades	app/sdk/cards/factory/bloodstorm/faction2.coffee
Cards.Spell.EvilXerox	FX.Cards.Spell.UnleashTheEvil	app/sdk/cards/factory/coreshatter/faction4.coffee
Cards.Spell.EvolutionaryApex	FX.Cards.Spell.EvolutionaryApex	app/sdk/cards/factory/firstwatch/faction5.coffee
Cards.Spell.Fealty	FX.Cards.Spell.Fealty	app/sdk/cards/factory/wartech/faction1.coffee
Cards.Spell.FestiveSpirit	FX.Cards.Spell.FestiveSpirit	app/sdk/cards/factory/misc/generic.coffee
Cards.Spell.FightingSpirit	FX.Cards.Spell.LionheartBlessing	app/sdk/cards/factory/shimzar/faction1.coffee
Cards.Spell.FirestormMantra	FX.Cards.Spell.FirestormMantra	app/sdk/cards/factory/firstwatch/faction2.coffee
Cards.Spell.FlamingStampede	FX.Cards.Spell.FlamingStampede	app/sdk/cards/factory/shimzar/faction5.coffee
Cards.Spell.FlashFreeze	FX.Cards.Spell.FlashFreeze	app/sdk/cards/factory/core/faction6.coffee
Cards.Spell.FlashReincarnation	FX.Cards.Spell.FlashReincarnation	app/sdk/cards/factory/core/faction5.coffee
Cards.Spell.FlawlessReflection	FX.Spell.FireTornado	app/sdk/cards/factory/firstwatch/faction6.coffee
Cards.Spell.Flicker	FX.Cards.Spell.Flicker	app/sdk/cards/factory/firstwatch/faction2.coffee
Cards.Spell.FollowupActivateBattlepet	FX.Cards.Spell.ApplyModifiers	app/sdk/cards/factory/misc/generic.coffee
Cards.Spell.FollowupDamage	FX.Cards.Spell.FollowupDamage	app/sdk/cards/factory/misc/generic.coffee
Cards.Spell.FollowupFight	FX.Cards.Spell.FollowupFight	app/sdk/cards/factory/misc/generic.coffee
Cards.Spell.FollowupHeal	FX.Cards.Spell.FollowupHeal	app/sdk/cards/factory/misc/generic.coffee
Cards.Spell.FollowupHollowGroveKeeper	FX.Cards.Spell.FollowupHollowGroveKeeper	app/sdk/cards/factory/misc/generic.coffee
Cards.Spell.FollowupKeeper	FX.Factions.Neutral.UnitSpawnFX	app/sdk/cards/factory/misc/generic.coffee
Cards.Spell.FollowupKillTargetByAttack	FX.Factions.Neutral.UnitSpawnFX	app/sdk/cards/factory/misc/generic.coffee
Cards.Spell.FollowupRandomTeleport	FX.Cards.Spell.FollowupRandomTeleport	app/sdk/cards/factory/misc/generic.coffee
Cards.Spell.FollowupSpawnEntityFromDeck	FX.Cards.Spell.ApplyModifiers	app/sdk/cards/factory/misc/generic.coffee
Cards.Spell.FollowupSwapPositions	FX.Cards.Spell.Juxtaposition	app/sdk/cards/factory/misc/generic.coffee
Cards.Spell.FollowupTeleport	FX.Cards.Spell.FollowupTeleport	app/sdk/cards/factory/misc/generic.coffee
Cards.Spell.FollowupTeleportEnemyToMe	FX.Cards.Spell.FollowupTeleportEnemyToMe	app/sdk/cards/factory/misc/generic.coffee
Cards.Spell.FollowupTeleportInFrontOfAnyGeneral	FX.Cards.Spell.FollowupTeleportInFrontOfAnyGeneral	app/sdk/cards/factory/misc/generic.coffee
Cards.Spell.FollowupTeleportMyGeneral	FX.Cards.Spell.FollowupTeleportMyGeneral	app/sdk/cards/factory/misc/generic.coffee
Cards.Spell.FollowupTeleportMyGeneralBehindEnemy	FX.Cards.Spell.FollowupTeleportMyGeneralBehindEnemy	app/sdk/cards/factory/misc/generic.coffee
Cards.Spell.FollowupTeleportNearMyGeneral	FX.Cards.Spell.FollowupTeleport	app/sdk/cards/factory/misc/generic.coffee
Cards.Spell.FollowupTeleportToFriendlyCreep	FX.Cards.Spell.FollowupTeleport	app/sdk/cards/factory/misc/generic.coffee
Cards.Spell.FortifiedAssault	FX.Cards.Spell.FortifiedAssault	app/sdk/cards/factory/firstwatch/faction1.coffee
Cards.Spell.FountainOfYouth	FX.Cards.Spell.FountainOfYouth	app/sdk/cards/factory/core/faction3.coffee
Cards.Spell.FractalReplication	FX.Spell.FireTornado	app/sdk/cards/factory/core/faction5.coffee
Cards.Spell.FrigidCorona	FX.Cards.Spell.FrigidCorona	app/sdk/cards/factory/bloodstorm/faction6.coffee
Cards.Spell.Frostburn	FX.Cards.Spell.Frostburn	app/sdk/cards/factory/shimzar/faction6.coffee
Cards.Spell.FuriousLings	FX.Cards.Spell.Shadowspawn	app/sdk/cards/factory/bloodstorm/faction4.coffee
Cards.Spell.GateToDudesHouse	FX.Cards.Spell.UnfathomableRite	app/sdk/cards/factory/coreshatter/faction4.coffee
Cards.Spell.GhostLightning	FX.Cards.Spell.GhostLightning	app/sdk/cards/factory/core/faction2.coffee
Cards.Spell.GlacialFissure	FX.Cards.Spell.GlacialFissure	app/sdk/cards/factory/firstwatch/faction6.coffee
Cards.Spell.GoneWithTheWind	FX.Cards.Spell.Wither	app/sdk/cards/factory/coreshatter/faction3.coffee
Cards.Spell.Gotatsu	FX.Cards.Spell.Gotatsu	app/sdk/cards/factory/firstwatch/faction2.coffee
Cards.Spell.GrabAThing	FX.Cards.Spell.PlanarFoundry	app/sdk/cards/factory/coreshatter/faction3.coffee
Cards.Spell.GravityWell	FX.Spell.FireTornado	app/sdk/cards/factory/core/faction6.coffee
Cards.Spell.GreaterFortitude	FX.Cards.Spell.GreaterFortitude	app/sdk/cards/factory/core/faction5.coffee
Cards.Spell.GreaterPhoenixFire	FX.Cards.Spell.PhoenixBarrage	app/sdk/cards/factory/coreshatter/faction2.coffee
Cards.Spell.HatchAnEgg	FX.Cards.Spell.HatchAnEgg	app/sdk/cards/factory/misc/generic.coffee
Cards.Spell.HeavensEclipse	FX.Cards.Spell.HeavensEclipse	app/sdk/cards/factory/core/faction2.coffee
Cards.Spell.HollowVortex	FX.Cards.Spell.KenshoVortex	app/sdk/cards/factory/coreshatter/faction2.coffee
Cards.Spell.HolyImmolation	FX.Cards.Spell.HolyImmolation	app/sdk/cards/factory/core/faction1.coffee
Cards.Spell.HomeostaticRebuke	FX.Cards.Spell.HomeostaticRebuke	app/sdk/cards/factory/wartech/faction5.coffee
Cards.Spell.HorrificVisage	FX.Cards.Spell.HorrificVisage	app/sdk/cards/factory/wartech/faction4.coffee
Cards.Spell.IceCage	FX.Cards.Spell.HailstonePrison	app/sdk/cards/factory/core/faction6.coffee
Cards.Spell.IceCapsule	FX.Cards.Spell.CryonicPotential	app/sdk/cards/factory/coreshatter/faction6.coffee
Cards.Spell.IncreasingDominance	FX.Cards.Spell.Bolster	app/sdk/cards/factory/coreshatter/faction1.coffee
Cards.Spell.IncreasingHeal	FX.Cards.Spell.Invigoration	app/sdk/cards/factory/coreshatter/faction5.coffee
Cards.Spell.IncreasingWinds	FX.Cards.Spell.Accumulonimbus	app/sdk/cards/factory/coreshatter/faction3.coffee
Cards.Spell.Infest	FX.Cards.Spell.Infest	app/sdk/cards/factory/wartech/faction4.coffee
Cards.Spell.InfiniteHowlers	FX.Cards.Spell.EndlessHunt	app/sdk/cards/factory/coreshatter/faction6.coffee
Cards.Spell.InkhornGaze	FX.Cards.Spell.InkhornGaze	app/sdk/cards/factory/shimzar/faction4.coffee
Cards.Spell.InklingSurge	FX.Cards.Spell.InklingSurge	app/sdk/cards/factory/firstwatch/faction4.coffee
Cards.Spell.InnerFocus	FX.Cards.Spell.InnerFocus	app/sdk/cards/factory/core/faction2.coffee
Cards.Spell.InnerOasis	FX.Cards.Spell.InnerOasis	app/sdk/cards/factory/core/faction3.coffee
Cards.Spell.Invincible	FX.Cards.Spell.Invincible	app/sdk/cards/factory/wartech/faction1.coffee
Cards.Spell.IroncliffeHeart	FX.Cards.Spell.IroncliffeHeart	app/sdk/cards/factory/shimzar/faction1.coffee
Cards.Spell.Joseki	FX.Cards.Spell.Joseki	app/sdk/cards/factory/unity/faction2.coffee
Cards.Spell.Juxtaposition	FX.Cards.Spell.Juxtaposition	app/sdk/cards/factory/core/faction2.coffee
Cards.Spell.KageLightning	FX.Cards.Spell.KageLightning	app/sdk/cards/factory/core/faction2.coffee
Cards.Spell.KillTarget	FX.Cards.Spell.KillTarget	app/sdk/cards/factory/misc/generic.coffee
Cards.Spell.KillTargetWithRanged	FX.Cards.Spell.KillTargetWithRanged	app/sdk/cards/factory/misc/generic.coffee
Cards.Spell.KillingEdge	FX.Cards.Spell.KillingEdge	app/sdk/cards/factory/core/faction2.coffee
Cards.Spell.Kindle	FX.Cards.Spell.Knucklestorm	app/sdk/cards/factory/coreshatter/faction2.coffee
Cards.Spell.KinematicProjection	FX.Cards.Spell.KinematicProjection	app/sdk/cards/factory/wartech/faction3.coffee
Cards.Spell.KineticEquilibrium	FX.Cards.Spell.KineticEquilibrium	app/sdk/cards/factory/core/faction5.coffee
Cards.Spell.KineticSurge	FX.Cards.Spell.KineticSurge	app/sdk/cards/factory/core/faction6.coffee
Cards.Spell.KingsGuardBBS	FX.Cards.Spell.Conscript	app/sdk/cards/factory/core/faction1.coffee
Cards.Spell.KoanOfHorns	FX.Cards.Spell.KoanOfHorns	app/sdk/cards/factory/shimzar/faction2.coffee
Cards.Spell.LastingJudgement	FX.Cards.Spell.LastingJudgement	app/sdk/cards/factory/core/faction1.coffee
Cards.Spell.LavaLance	FX.Cards.Spell.LavaLance	app/sdk/cards/factory/shimzar/faction5.coffee
Cards.Spell.LifeCoil	FX.Cards.Spell.LifeCoil	app/sdk/cards/factory/unity/faction1.coffee
Cards.Spell.LionheartBlessing	FX.Cards.Spell.LionheartBlessing	app/sdk/cards/factory/core/faction1.coffee
Cards.Spell.LostInTheDesert	FX.Cards.Spell.LostInTheDesert	app/sdk/cards/factory/wartech/faction3.coffee
Cards.Spell.LucentBeam	FX.Cards.Spell.LucentBeam	app/sdk/cards/factory/shimzar/faction1.coffee
Cards.Spell.LuminousCharge	FX.Cards.Spell.LuminousCharge	app/sdk/cards/factory/firstwatch/faction6.coffee
Cards.Spell.LurkingFear	FX.Cards.Spell.LurkingFear	app/sdk/cards/factory/shimzar/faction4.coffee
Cards.Spell.Maelstrom	FX.Spell.FireTornado	app/sdk/cards/factory/core/faction3.coffee
Cards.Spell.Magnetize	FX.Cards.Spell.Magnetize	app/sdk/cards/factory/core/faction1.coffee
Cards.Spell.ManaDeathgrip	FX.Cards.Spell.ManaDeathgrip	app/sdk/cards/factory/unity/faction6.coffee
Cards.Spell.ManaVortex	FX.Cards.Spell.ManaVortex	app/sdk/cards/factory/core/faction2.coffee
Cards.Spell.MarchOfTheBrontos	FX.Cards.Spell.ExtinctionEvent	app/sdk/cards/factory/coreshatter/faction5.coffee
Cards.Spell.MarkOfSolitude	FX.Cards.Spell.MarkOfSolitude	app/sdk/cards/factory/core/faction6.coffee
Cards.Spell.Martyrdom	FX.Cards.Spell.Martyrdom	app/sdk/cards/factory/core/faction1.coffee
Cards.Spell.MassFlight	FX.Cards.Spell.MassFlight	app/sdk/cards/factory/wartech/faction2.coffee
Cards.Spell.MechProgress	FX.Cards.Spell.MechProgress	app/sdk/cards/factory/wartech/faction2.coffee
Cards.Spell.Metalworking	FX.Cards.Spell.Metalmeld	app/sdk/cards/factory/coreshatter/faction3.coffee
Cards.Spell.Metamorphosis	FX.Cards.Spell.Metamorphosis	app/sdk/cards/factory/core/faction5.coffee
Cards.Spell.MindControlByAttackValue	FX.Cards.Spell.MindControlByAttackValue	app/sdk/cards/factory/misc/generic.coffee
Cards.Spell.MindSteal	FX.Cards.Spell.MindSteal	app/sdk/cards/factory/core/faction5.coffee
Cards.Spell.MirrorMeld	FX.Cards.Spell.MirrorMeld	app/sdk/cards/factory/shimzar/faction2.coffee
Cards.Spell.MistDragonSeal	FX.Cards.Spell.MistDragonSeal	app/sdk/cards/factory/core/faction2.coffee
Cards.Spell.MistWalking	FX.Cards.Spell.MistWalking	app/sdk/cards/factory/core/faction2.coffee
Cards.Spell.MoltenRebirth	FX.Cards.Spell.CascadingRebirth	app/sdk/cards/factory/unity/faction5.coffee
Cards.Spell.MoltenRebirthFollowup	FX.Cards.Spell.MoltenRebirth	app/sdk/cards/factory/unity/faction5.coffee
Cards.Spell.MonolithicVision	FX.Cards.Spell.MonolithicVision	app/sdk/cards/factory/wartech/faction3.coffee
Cards.Spell.NaturalSelection	FX.Cards.Spell.NaturalSelection	app/sdk/cards/factory/core/faction5.coffee
Cards.Spell.NaturesConfluence	FX.Cards.Spell.KineticEquilibrium	app/sdk/cards/factory/shimzar/faction5.coffee
Cards.Spell.NecroticSphere	FX.Cards.Spell.NecroticSphere	app/sdk/cards/factory/bloodstorm/faction4.coffee
Cards.Spell.NetherSummoning	FX.Cards.Spell.NetherSummoning	app/sdk/cards/factory/core/faction4.coffee
Cards.Spell.Nethermeld	FX.Cards.Spell.Nethermeld	app/sdk/cards/factory/firstwatch/faction4.coffee
Cards.Spell.Neurolink	FX.Cards.Spell.Neurolink	app/sdk/cards/factory/wartech/faction3.coffee
Cards.Spell.Numb	FX.Cards.Spell.Mesmerize	app/sdk/cards/factory/core/faction6.coffee
Cards.Spell.OnceMoreWithProvoke	FX.Cards.Spell.AmaranthineVow	app/sdk/cards/factory/coreshatter/faction1.coffee
Cards.Spell.OnyxBearSeal	FX.Cards.Spell.OnyxBearSeal	app/sdk/cards/factory/core/faction2.coffee
Cards.Spell.Overload	FX.Cards.Spell.Overload	app/sdk/cards/factory/core/faction5.coffee
Cards.Spell.Overwatch	FX.Cards.Spell.Overwatch	app/sdk/cards/factory/misc/generic.coffee
Cards.Spell.PandaJail	FX.Cards.Spell.Pandatentiary	app/sdk/cards/factory/coreshatter/faction2.coffee
Cards.Spell.Pandamonium	FX.Cards.Spell.OnyxBearSeal	app/sdk/cards/factory/shimzar/faction2.coffee
Cards.Spell.PermafrostShield	FX.Cards.Spell.IceCage	app/sdk/cards/factory/core/faction6.coffee
Cards.Spell.PhoenixFire	FX.Cards.Spell.PhoenixFire	app/sdk/cards/factory/core/faction2.coffee
Cards.Spell.PhoenixFireBBS	FX.Cards.Spell.PhoenixFire	app/sdk/cards/factory/bloodstorm/faction2.coffee
Cards.Spell.PlasmaStorm	FX.Cards.Spell.PlasmaStorm	app/sdk/cards/factory/core/faction5.coffee
Cards.Spell.PrimalBallast	FX.Cards.Spell.PrimalBallast	app/sdk/cards/factory/firstwatch/faction5.coffee
Cards.Spell.PrismBarrier	FX.Cards.Spell.AurynNexus	app/sdk/cards/factory/bloodstorm/faction1.coffee
Cards.Spell.PsionicStrike	FX.Cards.Spell.PsionicStrike	app/sdk/cards/factory/core/faction3.coffee
Cards.Spell.PsychicConduit	FX.Cards.Spell.PsychicConduit	app/sdk/cards/factory/shimzar/faction3.coffee
Cards.Spell.Punish	FX.Cards.Spell.Punish	app/sdk/cards/factory/bloodstorm/faction4.coffee
Cards.Spell.Rally	FX.Cards.Spell.MarchingOrders	app/sdk/cards/factory/coreshatter/faction1.coffee
Cards.Spell.RashasCurse	FX.Cards.Spell.RashasCurse	app/sdk/cards/factory/core/faction3.coffee
Cards.Spell.RazorSkin	FX.Cards.Spell.RazorSkin	app/sdk/cards/factory/shimzar/faction5.coffee
Cards.Spell.Reassemble	FX.Cards.Spell.Reassemble	app/sdk/cards/factory/firstwatch/faction3.coffee
Cards.Spell.Reggplicate	FX.Cards.Spell.MitoticInduction	app/sdk/cards/factory/coreshatter/faction5.coffee
Cards.Spell.Repulsion	FX.Cards.Spell.Repulsion	app/sdk/cards/factory/misc/generic.coffee
Cards.Spell.Resilience	FX.Cards.Spell.Lifestream	app/sdk/cards/factory/coreshatter/faction1.coffee
Cards.Spell.Riddle	FX.Cards.Spell.Riddle	app/sdk/cards/factory/monthly/m11_penny_arcade.coffee
Cards.Spell.RiteOfTheUndervault	FX.Cards.Spell.RiteOfTheUndervault	app/sdk/cards/factory/core/faction4.coffee
Cards.Spell.RitualBanishing	FX.Cards.Spell.RitualBanishing	app/sdk/cards/factory/core/faction4.coffee
Cards.Spell.RitualOfTheWind	FX.Cards.Spell.Polarity	app/sdk/cards/factory/core/faction6.coffee
Cards.Spell.Roar	FX.Cards.Spell.Roar	app/sdk/cards/factory/core/faction1.coffee
Cards.Spell.SaberspineSeal	FX.Cards.Spell.SaberspineSeal	app/sdk/cards/factory/core/faction2.coffee
Cards.Spell.SacrificeBBS	FX.Cards.Spell.Malice	app/sdk/cards/factory/core/faction4.coffee
Cards.Spell.Sanctify	FX.Cards.Spell.Sanctify	app/sdk/cards/factory/firstwatch/faction1.coffee
Cards.Spell.SaurianFinality	FX.Cards.Spell.SaurianFinality	app/sdk/cards/factory/wartech/faction5.coffee
Cards.Spell.ScionsFirstWish	FX.Spell.FireTornado	app/sdk/cards/factory/core/faction3.coffee
Cards.Spell.ScionsSecondWish	FX.Spell.FireTornado	app/sdk/cards/factory/core/faction3.coffee
Cards.Spell.ScionsThirdWish	FX.Spell.FireTornado	app/sdk/cards/factory/core/faction3.coffee
Cards.Spell.SeekerSquad	FX.Cards.Spell.SeekerSquad	app/sdk/cards/factory/wartech/faction2.coffee
Cards.Spell.SeekingEye	FX.Cards.Spell.SeekingEye	app/sdk/cards/factory/core/faction5.coffee
Cards.Spell.ShadowBlossom	FX.Cards.Spell.PainfulPluck	app/sdk/cards/factory/coreshatter/faction4.coffee
Cards.Spell.ShadowNova	FX.Cards.Spell.ShadowNova	app/sdk/cards/factory/core/faction4.coffee
Cards.Spell.ShadowReflection	FX.Cards.Spell.ShadowReflection	app/sdk/cards/factory/core/faction4.coffee
Cards.Spell.ShadowWaltz	FX.Cards.Spell.ShadowWaltz	app/sdk/cards/factory/shimzar/faction2.coffee
Cards.Spell.Shadowspawn	FX.Cards.Spell.Shadowspawn	app/sdk/cards/factory/core/faction4.coffee
Cards.Spell.Shadowstalk	FX.Cards.Spell.Shadowstalk	app/sdk/cards/factory/firstwatch/faction4.coffee
Cards.Spell.Shatter	FX.Cards.Spell.Shatter	app/sdk/cards/factory/wartech/faction6.coffee
Cards.Spell.SiphonEnergy	FX.Cards.Spell.SiphonEnergy	app/sdk/cards/factory/core/faction3.coffee
Cards.Spell.SkyBurial	FX.Cards.Spell.SkyBurial	app/sdk/cards/factory/shimzar/faction1.coffee
Cards.Spell.SkyPhalanx	FX.Cards.Spell.SkyPhalanx	app/sdk/cards/factory/shimzar/faction1.coffee
Cards.Spell.SnowPatrol	FX.Cards.Spell.SnowPatrol	app/sdk/cards/factory/firstwatch/faction6.coffee
Cards.Spell.SnowballBBS	FX.Cards.Spell.LesserWaterball	app/sdk/cards/factory/coreshatter/faction6.coffee
Cards.Spell.SoulshatterPact	FX.Cards.Spell.SoulshatterPact	app/sdk/cards/factory/core/faction4.coffee
Cards.Spell.Spaghettify	FX.Cards.Spell.DeepImpact	app/sdk/cards/factory/coreshatter/faction5.coffee
Cards.Spell.SpawnEntity	FX.Factions.Neutral.UnitSpawnFX	app/sdk/cards/factory/misc/generic.coffee
Cards.Spell.SpawnNeutralEntity	FX.Factions.Neutral.UnitSpawnFX	app/sdk/cards/factory/misc/generic.coffee
Cards.Spell.SpellDamage	FX.Cards.Spell.SpellDamage	app/sdk/cards/factory/misc/generic.coffee
Cards.Spell.SpellDamageOrHeal	FX.Cards.Spell.ApplyModifiers	app/sdk/cards/factory/misc/generic.coffee
Cards.Spell.SpellDuplicator	FX.Cards.Spell.ApplyModifiers	app/sdk/cards/factory/misc/generic.coffee
Cards.Spell.SpellSword1	FX.Cards.Spell.Murasame	app/sdk/cards/factory/core/faction2.coffee
Cards.Spell.SpellSword2	FX.Cards.Spell.Kiyomori	app/sdk/cards/factory/core/faction2.coffee
Cards.Spell.SpellSword3	FX.Cards.Spell.Tanahashi	app/sdk/cards/factory/core/faction2.coffee
Cards.Spell.SpellSword4	FX.Cards.Spell.Kotetsu	app/sdk/cards/factory/core/faction2.coffee
Cards.Spell.SphereOfDarkness	FX.Cards.Spell.SphereOfDarkness	app/sdk/cards/factory/shimzar/faction4.coffee
Cards.Spell.SpiralCounter	FX.Cards.Spell.SpiralCounter	app/sdk/cards/factory/firstwatch/faction2.coffee
Cards.Spell.SpiralTechnique	FX.Cards.Spell.SpiralTechnique	app/sdk/cards/factory/core/faction2.coffee
Cards.Spell.SpiritoftheWild	FX.Cards.Spell.SpiritoftheWild	app/sdk/cards/factory/core/faction6.coffee
Cards.Spell.StarsFury	FX.Cards.Spell.StarsFury	app/sdk/cards/factory/core/faction3.coffee
Cards.Spell.SteadfastFormation	FX.Cards.Spell.SteadfastFormation	app/sdk/cards/factory/wartech/faction1.coffee
Cards.Spell.StoneToSpears	FX.Cards.Spell.StoneToSpears	app/sdk/cards/factory/bloodstorm/faction3.coffee
Cards.Spell.StunBBS	FX.Cards.Spell.Crystallize	app/sdk/cards/factory/core/faction6.coffee
Cards.Spell.Substitution	FX.Cards.Spell.Substitution	app/sdk/cards/factory/wartech/faction2.coffee
Cards.Spell.SummonFiends	FX.Cards.Spell.AbyssalScar	app/sdk/cards/factory/bloodstorm/faction4.coffee
Cards.Spell.SummonHusks	FX.Cards.Spell.Malice	app/sdk/cards/factory/bloodstorm/faction4.coffee
Cards.Spell.SummoningStones	FX.Cards.Spell.CircleOfFabrication	app/sdk/cards/factory/coreshatter/faction3.coffee
Cards.Spell.SunBloom	FX.Cards.Spell.SunBloom	app/sdk/cards/factory/core/faction1.coffee
Cards.Spell.SundropElixir	FX.Cards.Spell.SundropElixir	app/sdk/cards/factory/core/faction1.coffee
Cards.Spell.Sunstrike	FX.Cards.Spell.SunStrike	app/sdk/cards/factory/wartech/faction1.coffee
Cards.Spell.SuperiorMirage	FX.Cards.Spell.SuperiorMirage	app/sdk/cards/factory/firstwatch/faction3.coffee
Cards.Spell.SwordsBBS	FX.Cards.Spell.PetalFlurry	app/sdk/cards/factory/core/faction2.coffee
Cards.Spell.TectonicSpikes	FX.Cards.Spell.TectonicSpikes	app/sdk/cards/factory/bloodstorm/faction5.coffee
Cards.Spell.Tempest	FX.Cards.Spell.Tempest	app/sdk/cards/factory/core/faction1.coffee
Cards.Spell.TempestBBS	FX.Cards.Spell.Tempest	app/sdk/cards/factory/bloodstorm/faction1.coffee
Cards.Spell.ThoughtExchange	FX.Cards.Spell.SynapticArbitrage	app/sdk/cards/factory/coreshatter/faction3.coffee
Cards.Spell.ThumpingWave	FX.Cards.Spell.ThumpingWave	app/sdk/cards/factory/shimzar/faction5.coffee
Cards.Spell.Thunderbomb	FX.Cards.Spell.Thunderbomb	app/sdk/cards/factory/wartech/faction2.coffee
Cards.Spell.TickleTendril	FX.Cards.Spell.Munch	app/sdk/cards/factory/coreshatter/faction4.coffee
Cards.Spell.Tremor	FX.Cards.Spell.Tremor	app/sdk/cards/factory/core/faction5.coffee
Cards.Spell.Triggered	FX.Cards.Spell.YieldingDepths	app/sdk/cards/factory/coreshatter/faction4.coffee
Cards.Spell.TrinityOath	FX.Cards.Spell.LastingJudgement	app/sdk/cards/factory/bloodstorm/faction1.coffee
Cards.Spell.TrueStrike	FX.Cards.Spell.TrueStrike	app/sdk/cards/factory/core/faction1.coffee
Cards.Spell.TwilightReiki	FX.Cards.Spell.TwilightReiki	app/sdk/cards/factory/firstwatch/faction2.coffee
Cards.Spell.TwinStrike	FX.Cards.Spell.TwinStrike	app/sdk/cards/factory/core/faction2.coffee
Cards.Spell.TwoForMe	FX.Cards.Spell.DemonicConversion	app/sdk/cards/factory/coreshatter/faction4.coffee
Cards.Spell.UpperHand	FX.Cards.Spell.UpperHand	app/sdk/cards/factory/wartech/faction5.coffee
Cards.Spell.VaathsBrutality	FX.Cards.Spell.VaathsBrutality	app/sdk/cards/factory/firstwatch/faction5.coffee
Cards.Spell.ValeAscension	FX.Cards.Spell.ValeAscension	app/sdk/cards/factory/firstwatch/faction1.coffee
Cards.Spell.ValknusSeal	FX.Cards.Spell.MindSteal	app/sdk/cards/factory/bloodstorm/faction5.coffee
Cards.Spell.VeilOfUnraveling	FX.Cards.Spell.Obliterate	app/sdk/cards/factory/shimzar/faction4.coffee
Cards.Spell.Vellumscry	FX.Cards.Spell.Vellumscry	app/sdk/cards/factory/wartech/faction4.coffee
Cards.Spell.VerdentFulmination	FX.Cards.Spell.VerdentFulmination	app/sdk/cards/factory/firstwatch/faction5.coffee
Cards.Spell.VespyrianMight	FX.Cards.Spell.VespyrianMight	app/sdk/cards/factory/firstwatch/faction6.coffee
Cards.Spell.VespyricCall	FX.Cards.Spell.Cryogenesis	app/sdk/cards/factory/shimzar/faction6.coffee
Cards.Spell.VoidPulse	FX.Cards.Spell.VoidPulse	app/sdk/cards/factory/core/faction4.coffee
Cards.Spell.VoidSteal	FX.Cards.Spell.VoidSteal	app/sdk/cards/factory/shimzar/faction4.coffee
Cards.Spell.WailingOverdrive	FX.Cards.Spell.Mesmerize	app/sdk/cards/factory/shimzar/faction6.coffee
Cards.Spell.WarSurge	FX.Cards.Spell.WarSurge	app/sdk/cards/factory/core/faction1.coffee
Cards.Spell.Warbird	FX.Cards.Spell.Warbird	app/sdk/cards/factory/core/faction6.coffee
Cards.Spell.WhisperOfTheSands	FX.Cards.Spell.DervishCast	app/sdk/cards/factory/shimzar/faction3.coffee
Cards.Spell.WindShroud	FX.Cards.Spell.WindShroud	app/sdk/cards/factory/core/faction3.coffee
Cards.Spell.WintersWake	FX.Cards.Spell.WintersWake	app/sdk/cards/factory/shimzar/faction6.coffee
Cards.Spell.Wintertide	FX.Cards.Spell.Wintertide	app/sdk/cards/factory/wartech/faction6.coffee
Cards.Spell.WraithlingSwarm	FX.Cards.Spell.WraithlingSwarm	app/sdk/cards/factory/core/faction4.coffee
Cards.Spell.YellRealLoud	FX.Cards.Spell.Bellow	app/sdk/cards/factory/coreshatter/faction5.coffee
Cards.Tile.BonusMana	FX.Cards.Tile.BonusMana	app/sdk/cards/factory/misc/tiles.coffee
Cards.Tile.FrostfireChest	FX.Cards.Tile.FrostfireChest	app/sdk/cards/factory/misc/tiles.coffee
Cards.Tile.Hallowed	FX.Cards.Tile.Hallowed	app/sdk/cards/factory/misc/tiles.coffee
Cards.Tile.PrimalMojo	FX.Cards.Tile.PrimalMojo	app/sdk/cards/factory/misc/tiles.coffee
Cards.Tile.SandPortal	FX.Cards.Tile.SandPortal	app/sdk/cards/factory/misc/tiles.coffee
Cards.Tile.Shadow	FX.Cards.Tile.Shadow	app/sdk/cards/factory/misc/tiles.coffee
Cards.Tutorial.TutorialAdept	FX.Cards.Faction1.WindbladeAdept	app/sdk/cards/factory/misc/tutorial.coffee
Cards.Tutorial.TutorialBloodshardGolem	FX.Cards.Neutral.BloodshardGolem	app/sdk/cards/factory/misc/tutorial.coffee
Cards.Tutorial.TutorialBrawler	FX.Cards.Faction1.LysianBrawler	app/sdk/cards/factory/misc/tutorial.coffee
Cards.Tutorial.TutorialBrightmossGolem	FX.Cards.Neutral.BrightmossGolem	app/sdk/cards/factory/misc/tutorial.coffee
Cards.Tutorial.TutorialDragoneboneGolem	FX.Cards.Neutral.DragoneboneGolem	app/sdk/cards/factory/misc/tutorial.coffee
Cards.Tutorial.TutorialGeneral	FX.Cards.Faction1.General	app/sdk/cards/factory/misc/tutorial.coffee
Cards.Tutorial.TutorialGro	FX.Cards.Neutral.Gro	app/sdk/cards/factory/misc/tutorial.coffee
Cards.Tutorial.TutorialGuardian	FX.Cards.Faction1.IroncliffeGuardian	app/sdk/cards/factory/misc/tutorial.coffee
Cards.Tutorial.TutorialIceGolem	FX.Cards.Neutral.HailstoneHowler	app/sdk/cards/factory/misc/tutorial.coffee
Cards.Tutorial.TutorialKolossus	FX.Cards.Neutral.PrimusShieldmaster	app/sdk/cards/factory/misc/tutorial.coffee
Cards.Tutorial.TutorialLion	FX.Cards.Faction1.AzuriteLion	app/sdk/cards/factory/misc/tutorial.coffee
Cards.Tutorial.TutorialOpponentGeneral1	FX.Cards.Faction1.CaliberO	app/sdk/cards/factory/misc/tutorial.coffee
Cards.Tutorial.TutorialOpponentGeneral2	FX.Cards.Neutral.Rook	app/sdk/cards/factory/misc/tutorial.coffee
Cards.Tutorial.TutorialOpponentGeneral4	FX.Cards.Faction6.PrismaticGiant	app/sdk/cards/factory/misc/tutorial.coffee
Cards.Tutorial.TutorialRepulsor	FX.Cards.Neutral.RepulsionBeast	app/sdk/cards/factory/misc/tutorial.coffee
Cards.Tutorial.TutorialRookie	FX.Cards.Neutral.Rook	app/sdk/cards/factory/misc/tutorial.coffee
Cards.Tutorial.TutorialSaberspineTiger	FX.Cards.Neutral.SaberspineTiger	app/sdk/cards/factory/misc/tutorial.coffee
Cards.Tutorial.TutorialSignatureGeneral	FX.Cards.Faction1.General	app/sdk/cards/factory/misc/tutorial.coffee
Cards.Tutorial.TutorialSkyrockGolem	FX.Cards.Neutral.SkyrockGolem	app/sdk/cards/factory/misc/tutorial.coffee
Cards.Tutorial.TutorialStormmetalGolem	FX.Cards.Neutral.StormmetalGolem	app/sdk/cards/factory/misc/tutorial.coffee
Cards.Tutorial.TutorialThornNeedler	FX.Cards.Neutral.ThornNeedler	app/sdk/cards/factory/misc/tutorial.coffee
Cards.Tutorial.TutorialVox	FX.Cards.Neutral.Vex	app/sdk/cards/factory/misc/tutorial.coffee
Cards.TutorialArtifact.TutorialSunstoneBracers	FX.Cards.Artifact.SunstoneBracers	app/sdk/cards/factory/misc/tutorial.coffee
Cards.TutorialSpell.TutorialFireOrb	FX.Cards.Spell.FireOrb	app/sdk/cards/factory/misc/tutorial.coffee
Cards.TutorialSpell.TutorialFrozenFinisher	FX.Cards.Spell.FreezingOrb	app/sdk/cards/factory/misc/tutorial.coffee
Cards.TutorialSpell.TutorialPlayerTrueStrike	FX.Cards.Spell.TrueStrike	app/sdk/cards/factory/misc/tutorial.coffee
