fx_id	fx_type	parent	sprites	sounds	particles
AbhorrentUnbirth.SpellCastFX	SpellCastFX	AbhorrentUnbirth	fxTeleportOrangeOrb,fx_beamfire,fx_f4_deathfire_crescendo		
Abjudicator.UnitAttackedFX	UnitAttackedFX	Abjudicator	ForceField,fxElectricalGroundUpBlue		
AbyssalCrawler.UnitAttackedFX	UnitAttackedFX	AbyssalCrawler	fxCollisionSparksPurple		
AbyssalJuggernaut.UnitAttackedFX	UnitAttackedFX	AbyssalJuggernaut	fxSmokeGround,fxExplosionMediumBlueGround		
AbyssalScar.ModifierAppliedFX	ModifierAppliedFX	AbyssalScar	fx_f4_bbs_abyssalscar		
AbyssianStrength.SpellCastFX	SpellCastFX	AbyssianStrength	fx_f4_wraithlingfury		
Accumulonimbus.SpellCastFX	SpellCastFX	Accumulonimbus	fxSandTileSpawn,fx_tornadoswirl,fx_ringswirl		
Actions.MoveSourceFX	MoveSourceFX	Actions	fxTeleportRecall2,fxSwirlRingsBlue		
AegisBarrier.SpellCastFX	SpellCastFX	AegisBarrier	FloatingShield,ForceField,fxFaerieFireBlue		
AerialRift.SpellCastFX	SpellCastFX	AerialRift	fxTeleportYellowOrb		
Aethermaster.UnitAttackedFX	UnitAttackedFX	Aethermaster	fxImpactMediumBlue,fxPlasmaBlueHorizontal,fxElectricalGroundUpBlue		
Afterglow.SpellAppliedFX	SpellAppliedFX	Afterglow	fx_f1_bbs_afterglow		
AlcuinLoremaster.UnitAttackedFX	UnitAttackedFX	AlcuinLoremaster	fxCollisionSparksRed,fxElectricalGroundUpRed,fxElectricalGroundUpRed		
Allomancer.UnitAttackedFX	UnitAttackedFX	Allomancer	fxElectricalGroundUpBlue,fxElectricalGroundUpBlue,fxExplosionMediumBlueGround		
AlterRexx.UnitAttackedFX	UnitAttackedFX	AlterRexx	fxCollisionSparksBlue,fxExplosionMediumBlueGround		
AmaranthineVow.SpellCastFX	SpellCastFX	AmaranthineVow	fx_f1_lasting_judgment,fxHolyTileSpawn		
Amplification.SpellCastFX	SpellCastFX	Amplification	fx_f5_amplification,fxSwirlRingsGreen		
Amu.UnitAttackedFX	UnitAttackedFX	Amu	fxCollisionSparksGreen,fxImpactWhiteMedium		
AncestralDivination.SpellCastFX	SpellCastFX	AncestralDivination	fx_f2_ancestralpact,fxSwirlRingsGreen		
AncientGrove.UnitAttackedFX	UnitAttackedFX	AncientGrove	fxBubbleEnergySootGround		
AncientKnowledge.SpellCastFX	SpellCastFX	AncientKnowledge	fx_crossslash_x,fx_neutral_riddle		
AperionsClaim.SpellCastFX	SpellCastFX	AperionsClaim	fx_f1_sunbloom,fx_f1_aperionssurge		
ApplyModifiers.SpellCastFX	SpellCastFX	ApplyModifiers	fxBuffSimpleGold,fxSmokeGround		
ArakiHeadhunter.UnitAttackedFX	UnitAttackedFX	ArakiHeadhunter	fxCollisionSparksOrange,fxExplosionOrangeSmoke,fxExplosionOrangeSmoke,fxClawSlash		
ArcaneHeart.SpellAppliedFX	SpellAppliedFX	ArcaneHeart	fx_f2_bbs_arcaneheart		
ArcaneIllusion.UnitAttackedFX	UnitAttackedFX	ArcaneIllusion	fxCollisionSparksBlue,fxCollisionSparksBlue,fxExplosionMediumBlueGround		
ArchonSpellbinder.UnitAttackedFX	UnitAttackedFX	ArchonSpellbinder	fxChainLightningRed,fxPlasmaRedVertical,fxCollisionSparksOrange,fxFaerieFirePurple		
ArclyteSentinel.UnitAttackedFX	UnitAttackedFX	ArclyteSentinel	fxPlasmaBlueVertical,fxExplosionMediumBlueGround		
ArcticDisplacer.UnitAttackedFX	UnitAttackedFX	ArcticDisplacer	fxCollisionSparksBlue,fxClawSlash		
ArcticRhyno.UnitAttackedFX	UnitAttackedFX	ArcticRhyno	fxCollisionSparksBlue		
AridUnmaking.SpellAppliedFX	SpellAppliedFX	AridUnmaking	fx_f5_earthsphere_orange		
ArrowWhistler.UnitAttackedFX	UnitAttackedFX	ArrowWhistler	neutralSwornAvengerProjectile,fxImpactBigOrange,fxExplosionOrangeSmoke,fxCollisionSparksOrange		ptcl_projectile_trail
ArrowWhistler.emitFX	emitFX	ArrowWhistler			ptcl_projectile_trail
ArtifactDefiler.SpellAppliedFX	SpellAppliedFX	ArtifactDefiler	fxElectricalGroundUpYellow,fxElectricalGroundUpYellow,fxArtifactBreak		
ArtifactHunter.UnitAttackedFX	UnitAttackedFX	ArtifactHunter	fxCollisionSparksBlue		
AshMephyt.UnitAttackedFX	UnitAttackedFX	AshMephyt	fxCollisionSparksPurple,fxExplosionPurpleSmoke,fxExplosionPurpleSmoke,fxFaerieFirePurple		
Assassination.SpellCastFX	SpellCastFX	Assassination	fx_f2_innerfocus,fx_f2_manavortex		
AstralCrusader.UnitAttackedFX	UnitAttackedFX	AstralCrusader	fxElectricalGroundUpBlue,fxPlasmaBlueHorizontal		
AstralFlood.SpellCastFX	SpellCastFX	AstralFlood	fxExplosionGroundSmokeSwirl,fxBuffSimpleGold,fxSmokeGround		
AstralPhasing.SpellAppliedFX	SpellAppliedFX	AstralPhasing	fxPlasmaBlueHorizontal,fxYellowTeleporterBeam,fxPlasmaBlueHorizontal		
Auroraboros.SpellCastFX	SpellCastFX	Auroraboros	fx_f6_cryogenesis		
AurorasTears.SpellAppliedFX	SpellAppliedFX	AurorasTears	fx_f3_aurorastears		
AurynNexus.SpellCastFX	SpellCastFX	AurynNexus	fx_f1_aurynnexus		
AutarchsGifts.SpellAppliedFX	SpellAppliedFX	AutarchsGifts	fxHeavensStrike,fx_f3_entropicdecay		
Avalanche.SpellCastFX	SpellCastFX	Avalanche	fx_f6_cryogenesis		
AymaraHealer.UnitAttackedFX	UnitAttackedFX	AymaraHealer	fxCollisionSparksOrange,fxImpactRingVerticalWhite		
AzureDrake.UnitAttackedFX	UnitAttackedFX	AzureDrake	fxCollisionSparksBlue,fxClawSlash		
AzureHornShaman.UnitAttackedFX	UnitAttackedFX	AzureHornShaman	fxChainLightningBlue,fxPlasmaBlueHorizontal		
AzureSummoning.SpellCastFX	SpellCastFX	AzureSummoning	fxTeleportBlueOrb,fx_f3_fountainofyouth		
AzuriteLion.UnitAttackedFX	UnitAttackedFX	AzuriteLion	fxClawSlash,fxClawSlash		
Bamboozle.SpellCastFX	SpellCastFX	Bamboozle	fxTeleportRecallRed,fx_f2_onyxbearseal		
Bastion.UnitAttackedFX	UnitAttackedFX	Bastion	fxCollisionSparksOrange,fxExplosionOrangeSmoke,fxExplosionOrangeSmoke		
BeamShock.SpellAppliedFX	SpellAppliedFX	BeamShock	fxSmokeGround,f1CasterProjectile,fxImpactBigOrange		
BeastCharger.UnitAttackedFX	UnitAttackedFX	BeastCharger	fxCollisionSparksBlue,fxClawSlash		
Bellow.SpellCastFX	SpellCastFX	Bellow	fx_f5_flashreincarnation		
Betrayal.SpellCastFX	SpellCastFX	Betrayal	fx_f4_nethersummoning,fx_f4_darkseed		
BlackLocust.UnitAttackedFX	UnitAttackedFX	BlackLocust	fxCollisionSparksOrange,fxClawSlash,fxClawSlash		
BlackSandBurrower.UnitAttackedFX	UnitAttackedFX	BlackSandBurrower	fxCollisionSparksOrange,fxClawSlash,fxClawSlash		
BlackSolus.UnitAttackedFX	UnitAttackedFX	BlackSolus	fxCollisionSparksPurple,fxExplosionPurpleSmoke,fxExplosionPurpleSmoke		
Blast.UnitPrimaryAttackedFX	UnitPrimaryAttackedFX	Blast	fx_f3_blast		
BlastStrong.UnitPrimaryAttackedFX	UnitPrimaryAttackedFX	BlastStrong	fx_f3_blaststarfire		
Blindscorch.SpellCastFX	SpellCastFX	Blindscorch	fx_f3_blindscorch,fxCleanse		
Blink.SpellCastFX	SpellCastFX	Blink	fx_f2_bbs_blink		
BlisteringSkorn.UnitAttackedFX	UnitAttackedFX	BlisteringSkorn	fxCollisionSparksOrange,fxClawSlash,fxClawSlash		
BloodEchoes.SpellCastFX	SpellCastFX	BloodEchoes	fx_multislash_full,fx_f4_consumingrebirth		
BloodOfAir.SpellCastFX	SpellCastFX	BloodOfAir	fx_f3_rashascurse,fx_tornadoswirl,fxBladestorm		
BloodRage.SpellAppliedFX	SpellAppliedFX	BloodRage	fx_f5_flashreincarnation,fx_f5_naturalselection		
BloodTaura.UnitAttackedFX	UnitAttackedFX	BloodTaura	fxCollisionSparksRed,fxExplosionBigBall_MetalSlug,fxClawSlash		
Bloodletter.UnitAttackedFX	UnitAttackedFX	Bloodletter	fxCollisionSparksRed,fxClawSlash,fxImpactRingVerticalWhite		
BloodmoonPriestess.UnitAttackedFX	UnitAttackedFX	BloodmoonPriestess	fxSiphon,fxCollisionSparksOrange		
BloodmoonPriestess.impactFX	impactFX	BloodmoonPriestess	fxCollisionSparksOrange		
BloodshardGolem.UnitAttackedFX	UnitAttackedFX	BloodshardGolem	fxCollisionSparksRed,fxImpactWhiteMedium		
BloodtearAlchemist.UnitAttackedFX	UnitAttackedFX	BloodtearAlchemist	fxCollisionSparksBlue		
Bolster.SpellCastFX	SpellCastFX	Bolster	fxEnergyHaloGround,fxYellowTeleporterBeam,fx_f1_lionheartblessing		
Bombard.SpellCastFX	SpellCastFX	Bombard	fxTeleportOrangeOrb,fx_f2_innerfocus		
BoneSwarm.SpellAppliedFX	SpellAppliedFX	BoneSwarm	fx_f3_boneswarm,fxSwirlRingsBlue,fx_f3_boneswarm		
Bonereaper.UnitAttackedFX	UnitAttackedFX	Bonereaper	fxCrossSlash,fxCrossSlash,fxFaerieFirePurple		
BoulderHurl.SpellCastFX	SpellCastFX	BoulderHurl	fxImpactRedBig,fxSmokeGround		
BoundedLifeforce.SpellAppliedFX	SpellAppliedFX	BoundedLifeforce	fx_f5_manaburn,fx_f5_boundedlife		
BrazierGoldenFlame.UnitAttackedFX	UnitAttackedFX	BrazierGoldenFlame	fxImpactBigOrange,fxEnergyHaloGround		
BrazierRedSand.UnitAttackedFX	UnitAttackedFX	BrazierRedSand	fxImpactWhiteMedium,fxCollisionSparksBlue		
BreathOfTheUnborn.SpellCastFX	SpellCastFX	BreathOfTheUnborn	fx_f4_darkfiresacrifice		
BrightmossGolem.UnitAttackedFX	UnitAttackedFX	BrightmossGolem	fxCollisionSparksGreen,fxImpactGreenBig,fxSmokeGround		
BrilliantPlume.SpellAppliedFX	SpellAppliedFX	BrilliantPlume	fxImpactGreenBig,fxImpactBigOrange,fxImpactRedBig,fxImpactBlueBig		
BurdenOfKnowledge.SpellAppliedFX	SpellAppliedFX	BurdenOfKnowledge	fxTeleportRecallBlue,fxImpactMediumBlue		
CaliberO.UnitAttackedFX	UnitAttackedFX	CaliberO	fxElectricalGroundUpYellow,fxLightningHitGreen,fxElectricalGroundUpYellow,fxSmokeGround		
CallToArms.SpellAppliedFX	SpellAppliedFX	CallToArms	fx_f1_sunbloom,fxTeleportBlueOrb,fx_f1_warsurge		
Cards.SpellCastFX	SpellCastFX	Cards	fx_f4_shadownova		
CascadingRebirth.SpellCastFX	SpellCastFX	CascadingRebirth	fxTeleportOrangeOrb,fx_f5_earthsphere		
CassyvaSoulreaper.UnitAttackedFX	UnitAttackedFX	CassyvaSoulreaper	fxCollisionSparksPurple,fxExplosionPurpleSmoke,fxImpactRingVerticalWhite		
CataclysmicFault.SpellCastFX	SpellCastFX	CataclysmicFault	fx_f3_cataclysmicfault		
CelestialPhantom.UnitAttackedFX	UnitAttackedFX	CelestialPhantom	fxClawSlash,fxClawSlash,fxFaerieFireRed		
Chakkram.UnitAttackedFX	UnitAttackedFX	Chakkram	fxCollisionSparksOrange,fxExplosionOrangeSmoke,fxExplosionOrangeSmoke		
ChakriAvatar.UnitAttackedFX	UnitAttackedFX	ChakriAvatar	neutralMechaz0rSuperProjectile,fxImpactBigOrange		ptcl_projectile_trail
ChakriAvatar.emitFX	emitFX	ChakriAvatar			ptcl_projectile_trail
ChanneledBreath.SpellAppliedFX	SpellAppliedFX	ChanneledBreath	fxYellowTeleporterBeam,fxTeleportRecall		
ChaosElemental.UnitAttackedFX	UnitAttackedFX	ChaosElemental	fxElectricalGroundUpRed,fxElectricalGroundUpRed,fxElectricalGroundUpRed		
ChokingTendrils.SpellAppliedFX	SpellAppliedFX	ChokingTendrils	fx_f4_shadownova		
ChromaticCold.SpellCastFX	SpellCastFX	ChromaticCold	fx_crossslash_x,fx_f6_chromaticcold		
ChrysalisBurst.SpellCastFX	SpellCastFX	ChrysalisBurst	fx_f5_amplification,fxTendrilsGreen,fxTendrilsGreen,fxTendrilsGreen		
CircleLife.SpellCastFX	SpellCastFX	CircleLife	fx_f1_circlelife		
CircleOfDesiccation.SpellCastFX	SpellCastFX	CircleOfDesiccation	fx_f3_circleofdessication		
CircleOfFabrication.SpellCastFX	SpellCastFX	CircleOfFabrication	fx_f3_circleofdessication		
CobraStrike.SpellCastFX	SpellCastFX	CobraStrike	fx_f2_twinstrike_part2,fx_f2_teleportsmoke,fxSmokeGround		
CoiledCrawler.UnitAttackedFX	UnitAttackedFX	CoiledCrawler	fxImpactOrangeSmall,fxCollisionSparksPurple,fxFaerieFireGreen,fxCrossSlash		
Congregation.SpellCastFX	SpellCastFX	Congregation	fx_f1_aurynnexus,fx_f1_warsurge		
Conscript.SpellAppliedFX	SpellAppliedFX	Conscript	fx_f1_bbs_conscript		
ConsumingRebirth.SpellCastFX	SpellCastFX	ConsumingRebirth	fx_crossslash,fx_f4_consumingrebirth		
CorporealCadence.SpellAppliedFX	SpellAppliedFX	CorporealCadence	fx_crossslash_x,fx_tornadoswirl,fx_f4_shadowreflection		
CosmicFlesh.SpellCastFX	SpellCastFX	CosmicFlesh	fx_f3_cosmicflesh		
CrimsonCoil.SpellCastFX	SpellCastFX	CrimsonCoil	fxFireTornado,fxExplosionGroundSmokeSwirl,fxImpactRedMed		
CrimsonOculus.UnitAttackedFX	UnitAttackedFX	CrimsonOculus	fxCollisionSparksOrange,fxImpactWhiteMedium,fxExplosionMediumBlueGround		
Crossbones.UnitAttackedFX	UnitAttackedFX	Crossbones	neutralCrossbonesProjectile,fxImpactMediumBlue,fxCollisionSparksBlue		ptcl_projectile_trail
Crossbones.emitFX	emitFX	Crossbones			ptcl_projectile_trail
Cryogenesis.SpellCastFX	SpellCastFX	Cryogenesis	fx_f6_cryogenesis,fx_f5_earthsphere_blue		
CryonicPotential.SpellCastFX	SpellCastFX	CryonicPotential	fx_f6_hailstoneprison,fxTeleportBlueOrb		
CrystalCloaker.UnitAttackedFX	UnitAttackedFX	CrystalCloaker	fxCollisionSparksBlue,fxCollisionSparksBlue,fxCollisionSparksBlue		
CrystalReinforce.SpellCastFX	SpellCastFX	CrystalReinforce	fx_f6_chromaticcold,fxTeleportBlueOrb		
Crystallize.SpellAppliedFX	SpellAppliedFX	Crystallize	fx_f6_bbs_crystallize		
CurseOfAgony.SpellCastFX	SpellCastFX	CurseOfAgony	fx_f4_nethersummoning,fx_f4_curseofagony		
DaemonicLure.SpellCastFX	SpellCastFX	DaemonicLure	fx_ringswirl,fx_f4_daemoniclure		
DaggerKiri.UnitAttackedFX	UnitAttackedFX	DaggerKiri	fxCollisionSparksOrange,fxClawSlash,fxClawSlash		
DampeningWave.SpellAppliedFX	SpellAppliedFX	DampeningWave	fxCleanse,fxCleanse		ptcl_circleswirls
DanceOfDreams.SpellCastFX	SpellCastFX	DanceOfDreams	fx_f5_manaburn		
DancingBlades.UnitAttackedFX	UnitAttackedFX	DancingBlades	fxCollisionSparksRed,fx_slashfrenzy		
DarkNemesis.UnitAttackedFX	UnitAttackedFX	DarkNemesis	fxExplosionMediumBlueGround		
DarkSacrifice.SpellCastFX	SpellCastFX	DarkSacrifice	fx_f2_eightgates_purpleflame,fx_f4_darkfiresacrifice		
DarkSeed.SpellAppliedFX	SpellAppliedFX	DarkSeed	fx_f4_darkseed		
DarkSiren.UnitAttackedFX	UnitAttackedFX	DarkSiren	fxCollisionSparksPurple,fxCollisionSparksPurple,fxCrossSlash,fxCrossSlash,fxFaerieFirePurple		
DarkTransformation.SpellCastFX	SpellCastFX	DarkTransformation	fx_f4_darkfiretransformation		
DarkspineElemental.UnitAttackedFX	UnitAttackedFX	DarkspineElemental	fxExplosionPurpleSmoke,fxCrossSlash,fxCollisionSparksPurple		
DauntlessAdvance.SpellCastFX	SpellCastFX	DauntlessAdvance	fxTeleportYellowOrb		
DeathBlighter.UnitAttackedFX	UnitAttackedFX	DeathBlighter	fxExplosionPurpleSmoke,fxExplosionPurpleSmoke,fxFaerieFirePurple		
DeathfireCrescendo.SpellCastFX	SpellCastFX	DeathfireCrescendo	fx_flamesphere,fx_f2_eightgates_purpleflame,fx_f4_deathfire_crescendo		
Deathmark.SpellCastFX	SpellCastFX	Deathmark	fx_crossslash_x,fx_f2_backstab		
DeathstrikeSeal.SpellCastFX	SpellCastFX	DeathstrikeSeal	fx_f2_deathstrikeseal,fxElectricalGroundUpYellow,fxSmokeGround,fxPlasmaRedVertical		
Decension.SpellAppliedFX	SpellAppliedFX	Decension	fx_f3_bbs_decension		
Decimate.SpellAppliedFX	SpellAppliedFX	Decimate	fxHeavensStrike,fxSmokeGround,fx_f1_decimate		
DeepImpact.SpellCastFX	SpellCastFX	DeepImpact	fxTeleportOrangeOrb,fx_f5_manaburn,fx_bouldersphere		
DeepfireDevourer.UnitAttackedFX	UnitAttackedFX	DeepfireDevourer	fxCollisionSparksBlue,fxClawSlash,fxFaerieFirePurple		
DemonicConversion.SpellCastFX	SpellCastFX	DemonicConversion	fx_f4_soulshatterpact		
Dervish.UnitAttackedFX	UnitAttackedFX	Dervish	fxCollisionSparksOrange,fxClawSlash,fxClawSlash,fxImpactRingVerticalWhite		
DervishCast.SpellCastFX	SpellCastFX	DervishCast	fxPlasmaBlueVertical,fx_f3_rashascurse,fxExplosionMediumBlueGround		
DiamondGolem.UnitAttackedFX	UnitAttackedFX	DiamondGolem	fxFrozenIceBlock		
Dilotas.UnitAttackedFX	UnitAttackedFX	Dilotas	fxCollisionSparksRed,fxElectricalGroundUpRed		
DilotasTombstone.UnitAttackedFX	UnitAttackedFX	DilotasTombstone	fxCollisionSparksRed,fxElectricalGroundUpRed		
DiretideFrenzy.SpellAppliedFX	SpellAppliedFX	DiretideFrenzy	fx_slashfrenzy,fx_animalslash		
DivineBond.SpellCastFX	SpellCastFX	DivineBond	fxBuffSimpleGold,fx_ringswirl,fx_f1_divinebond		
DivineLiturgy.SpellAppliedFX	SpellAppliedFX	DivineLiturgy	fx_f1_divinebond,fxBuffSimpleGold		
DivineSpark.SpellCastFX	SpellCastFX	DivineSpark	fx_f5_earthsphere_orange		
Doom.SpellCastFX	SpellCastFX	Doom	fx_f4_doom		
DragoneboneGolem.UnitAttackedFX	UnitAttackedFX	DragoneboneGolem	fxCollisionSparksOrange,fxSmokeGround,fxExplosionMediumBlueGround		
DrainMorale.SpellCastFX	SpellCastFX	DrainMorale	fx_f3_drainmorale,fxBuffSimpleGold		
DrainingWave.SpellAppliedFX	SpellAppliedFX	DrainingWave	fx_f3_blaststarfire,fx_f3_fountainofyouth,fx_f1_lionheartblessing		
DrakeDowager.UnitAttackedFX	UnitAttackedFX	DrakeDowager	f6MotherOfDrakesProjectile,fxImpactBigOrange,fxCollisionSparksOrange		ptcl_projectile_trail
DrakeDowager.emitFX	emitFX	DrakeDowager			ptcl_projectile_trail
Dreadnaught.UnitAttackedFX	UnitAttackedFX	Dreadnaught	fxCollisionSparksGreen,fxLightningHitGreen,fxElectricalGroundUpGreen		
Dreamgazer.UnitAttackedFX	UnitAttackedFX	Dreamgazer	fxImpactMediumBlue,fxCollisionSparksBlue,fxPlasmaBlueHorizontal,fxPlasmaBlueHorizontal		
DropLift.SpellAppliedFX	SpellAppliedFX	DropLift	fxTeleportRecallBlue,fxArtifactHit,fxArtifactHit		
Dunecaster.UnitAttackedFX	UnitAttackedFX	Dunecaster	fxCollisionSparksOrange,fxImpactRingVerticalWhite		
EXun.UnitAttackedFX	UnitAttackedFX	EXun	fxCollisionSparksBlue,fxPlasmaBlueHorizontal,fxElectricalGroundUpBlue		
EarthSister.UnitAttackedFX	UnitAttackedFX	EarthSister	fxExplosionBigBall_MetalSlug		
EarthSphere.SpellAppliedFX	SpellAppliedFX	EarthSphere	fx_f5_earthsphere		
EarthWalker.UnitAttackedFX	UnitAttackedFX	EarthWalker	fxLightningHitGreen,fxImpactGreenBig		
EchoingShriek.SpellCastFX	SpellCastFX	EchoingShriek	fx_f4_wraithlingfury		
Eclipse.UnitAttackedFX	UnitAttackedFX	Eclipse	fxCollisionSparksPurple,fxExplosionPurpleSmoke,fxExplosionPurpleSmoke,fxClawSlash		
EffulgentInfusion.SpellCastFX	SpellCastFX	EffulgentInfusion	fxFireTornado,fxLightningHitGreen,fxLightningHitGreen		
EggBBS.SpellAppliedFX	SpellAppliedFX	EggBBS	fx_f5_bbs_egg		
EggMorph.SpellCastFX	SpellCastFX	EggMorph	fx_f5_earthsphere,fxSwirlRingsGreen,fxSwirlRingsGreen		
EightGates.SpellCastFX	SpellCastFX	EightGates	fx_f2_eightgates_blue		
Elkowl.UnitAttackedFX	UnitAttackedFX	Elkowl	fxChainLightningRed,fxPlasmaBlueHorizontal,fxPlasmaBlueHorizontal,fxSmokeGround		
Elucidator.UnitAttackedFX	UnitAttackedFX	Elucidator	fxCollisionSparksGreen,fxLightningHitGreen,fxElectricalGroundUpGreen		
ElyxStormblade.UnitAttackedFX	UnitAttackedFX	ElyxStormblade	fxPlasmaBlueVertical,fxCollisionSparksBlue,fxCollisionSparksBlue		
EmbryoticInsight.SpellCastFX	SpellCastFX	EmbryoticInsight	f1CasterProjectile,fx_f5_earthsphere		
EmeraldRejuvenator.UnitAttackedFX	UnitAttackedFX	EmeraldRejuvenator	fxCollisionSparksGreen,fxElectricalGroundUpGreen,fxImpactWhiteMedium		
Enslave.SpellAppliedFX	SpellAppliedFX	Enslave	fx_f3_drainmorale,fxTendrilsGreen		
EntanglingShadow.SpellCastFX	SpellCastFX	EntanglingShadow	fx_flamesphere,fx_f4_shadownova		
EntropicDecay.SpellAppliedFX	SpellAppliedFX	EntropicDecay	fx_f3_entropicdecay,fx_vortexswirl		
EntropicGaze.SpellCastFX	SpellCastFX	EntropicGaze	fxTeleportOrangeOrb,fx_f5_flashreincarnation		
Envybaer.UnitAttackedFX	UnitAttackedFX	Envybaer	fxCollisionSparksRed,fxClawSlash		
EphemeralShroud.UnitAttackedFX	UnitAttackedFX	EphemeralShroud	fxExplosionMediumBlueGround		
EqualityConstraint.SpellCastFX	SpellCastFX	EqualityConstraint	fx_multislash_outro,fx_multislash_outro,fxImpactBlueBig,fxImpactBigOrange		
EssenceSculpt.SpellCastFX	SpellCastFX	EssenceSculpt	fx_f6_hailstoneprison,fxTeleportBlueOrb		
EtherealBlades.SpellAppliedFX	SpellAppliedFX	EtherealBlades	fx_fireslash,fx_fireslash		
EtherealWind.SpellCastFX	SpellCastFX	EtherealWind	fx_tornadoswirl,fx_ringswirl		
EvolutionaryApex.SpellCastFX	SpellCastFX	EvolutionaryApex	fx_f5_evolutionaryapex		
ExtinctionEvent.SpellCastFX	SpellCastFX	ExtinctionEvent	fx_flamesphere,fx_f5_amplification,fxPrimalTileSpawn		
Faction1.UnitAttackedFX	UnitAttackedFX	Faction1	fxImpactBigOrange,fxCollisionSparksBlue		
Faction2.UnitAttackedFX	UnitAttackedFX	Faction2	fxCollisionSparksRed,fxClawSlash,fxImpactRingVerticalWhite		
Faction2.UnitSpawnFX	UnitSpawnFX	Faction2	fx_f2_teleportsmoke,fx_f2_teleportsmoke,fxSmokeGround		
Faction3.UnitAttackedFX	UnitAttackedFX	Faction3	fxCollisionSparksOrange,fxImpactRingVerticalWhite		
Faction3.UnitSpawnFX	UnitSpawnFX	Faction3	fxTeleportRecallWhite,fxBladestorm,fxSmokeGround		
Faction4.UnitAttackedFX	UnitAttackedFX	Faction4	fxCollisionSparksPurple,fxCrossSlash,fxImpactRingVerticalWhite		
Faction4.UnitSpawnFX	UnitSpawnFX	Faction4	fx_f2_teleportsmoke,fx_f2_teleportsmoke,fxSmokeGround		
Faction5.UnitAttackedFX	UnitAttackedFX	Faction5	fxCollisionSparksGreen,fxLightningHitGreen,fxBubbleEnergySootGround		
Faction5.UnitSpawnFX	UnitSpawnFX	Faction5	fxTeleportRecallWhite,fxLightningHitGreen,fxSmokeGround		
Faction6.UnitAttackedFX	UnitAttackedFX	Faction6	fxImpactRingVerticalOrange,fxExplosionBigWhiteHot		
Faction6.UnitSpawnFX	UnitSpawnFX	Faction6	fxBlueWaterSplash,fxBlueWaterSplash,fxSwirlRingsBlue,fxSmokeGround		
Factions.UnitSpawnFX	UnitSpawnFX	Factions	fxTeleportRecallWhite,fx_f1_holyimmolation,fxSmokeGround		
Fealty.SpellCastFX	SpellCastFX	Fealty	fx_f1_lionheartblessing		
FenrirWarmaster.UnitAttackedFX	UnitAttackedFX	FenrirWarmaster	fxCollisionSparksBlue,fxClawSlash		
FireBlast.SpellAppliedFX	SpellAppliedFX	FireBlast	fxSearingChasm,fxSmokeGround		
FireOrb.SpellCastFX	SpellCastFX	FireOrb	fxTeleportOrangeOrb,fx_f3_entropicdecay,fx_f5_earthsphere_orange		
Fireblazer.UnitAttackedFX	UnitAttackedFX	Fireblazer	fxCollisionSparksOrange,fxExplosionOrangeSmoke,fxExplosionOrangeSmoke		
Firebreather.UnitAttackedFX	UnitAttackedFX	Firebreather	f5FireBreatherProjectile,fxImpactBigOrange,fxCollisionSparksOrange		ptcl_projectile_trail
Firebreather.emitFX	emitFX	Firebreather			ptcl_projectile_trail
Firestarter.UnitAttackedFX	UnitAttackedFX	Firestarter	fxCollisionSparksOrange,fxExplosionOrangeSmoke,fxExplosionOrangeSmoke,fxExplosionOrangeSmoke,fxExplosionOrangeSmoke		
FirestormMantra.SpellCastFX	SpellCastFX	FirestormMantra	fx_flamesphere,fx_f2_spiraltechnique02,fx_ringswirl		
FirstSwordofAkrane.UnitAttackedFX	UnitAttackedFX	FirstSwordofAkrane	fxImpactMediumBlue,fxCollisionSparksBlue		
FlameWing.UnitAttackedFX	UnitAttackedFX	FlameWing	fxCollisionSparksOrange,fxClawSlash		
FlamebloodWarlock.UnitAttackedFX	UnitAttackedFX	FlamebloodWarlock	neutralFlamebloodWarlockProjectile,fxImpactWhiteMedium,fxExplosionOrangeSmoke,fxCollisionSparksRed		
FlamebloodWarlock.impactFX	impactFX	FlamebloodWarlock	fxImpactWhiteMedium,fxExplosionOrangeSmoke,fxCollisionSparksRed		
FlamingStampede.SpellCastFX	SpellCastFX	FlamingStampede	fx_f5_flamingstampede		
FlareSlinger.UnitAttackedFX	UnitAttackedFX	FlareSlinger	f2FlareSlingerProjectile,fxImpactBigOrange,fxCollisionSparksOrange		ptcl_projectile_trail
FlareSlinger.emitFX	emitFX	FlareSlinger			ptcl_projectile_trail
FlashReincarnation.SpellCastFX	SpellCastFX	FlashReincarnation	fx_f5_flashreincarnation		
FlawlessReflection.SpellCastFX	SpellCastFX	FlawlessReflection	fx_f6_perfectreflection		
FollowupDamage.SpellAppliedFX	SpellAppliedFX	FollowupDamage	fxFaerieFireRed,fxExplosionOrangeSmoke,fx_slashfrenzy		
FollowupDamageDevour.SpellAppliedFX	SpellAppliedFX	FollowupDamageDevour	fxDevour,BloodExplosionBig,BloodExplosionMedium		
FortifiedAssault.SpellAppliedFX	SpellAppliedFX	FortifiedAssault	fxHolyTileSpawn,fxSwirlRingsBlue,fx_f1_truestrike		
FountainOfYouth.SpellCastFX	SpellCastFX	FountainOfYouth	fx_f3_fountainofyouth,fxCleanse		
FractalReplication.SpellCastFX	SpellCastFX	FractalReplication	fx_f5_fractalreplication		
FreezingOrb.SpellCastFX	SpellCastFX	FreezingOrb	fxTeleportBlueOrb,fx_f5_earthsphere_blue,fxSwirlRingsBlue		ptcl_pixelpuff
FrostboneNaga.UnitAttackedFX	UnitAttackedFX	FrostboneNaga	fxPlasmaBlueHorizontal,fxImpactRingVerticalWhite		
Frostburn.SpellCastFX	SpellCastFX	Frostburn	fx_f6_chromaticcold		
Gambler.UnitAttackedFX	UnitAttackedFX	Gambler	neutralGamblerProjectile,fxImpactBigOrange,fxCollisionSparksOrange		ptcl_projectile_trail
Gambler.emitFX	emitFX	Gambler			ptcl_projectile_trail
Game.CardDrawFX	CardDrawFX	Game	fx_carddraw		
GargantuanGrowth.SpellCastFX	SpellCastFX	GargantuanGrowth	fx_f5_mindsteal		
GhostLightning.SpellCastFX	SpellCastFX	GhostLightning	fxPlasmaRedVertical,fxPlasmaRedVertical		
GhostLynx.UnitAttackedFX	UnitAttackedFX	GhostLynx	fxCollisionSparksOrange,fxClawSlash		
GhostWolf.UnitAttackedFX	UnitAttackedFX	GhostWolf	fxCollisionSparksBlue,fxDevour		
GlacialFissure.SpellCastFX	SpellCastFX	GlacialFissure	fx_f6_cryogenesis		
GloomChaser.UnitAttackedFX	UnitAttackedFX	GloomChaser	fxCrossSlash,fxCollisionSparksPurple		
GoldenJusticar.UnitAttackedFX	UnitAttackedFX	GoldenJusticar	fxPlasmaBlueVertical		
GolemMetallurgist.UnitAttackedFX	UnitAttackedFX	GolemMetallurgist	fxCollisionSparksOrange,fxCollisionSparksOrange		
GolemVanquisher.UnitAttackedFX	UnitAttackedFX	GolemVanquisher	fxImpactOrangeSmall,fxCollisionSparksBlue		
GoreHorn.UnitAttackedFX	UnitAttackedFX	GoreHorn	fxCollisionSparksRed,BloodExplosionBig,BloodExplosionMedium		
Gotatsu.SpellCastFX	SpellCastFX	Gotatsu	fx_fireslash		
Grailmaster.UnitAttackedFX	UnitAttackedFX	Grailmaster	fxExplosionOrangeSmoke,fxExplosionOrangeSmoke		
GrandmasterZir.UnitAttackedFX	UnitAttackedFX	GrandmasterZir	fxCollisionSparksBlue,fxCollisionSparksBlue		
GreaterFortitude.ModifierAppliedFX	ModifierAppliedFX	GreaterFortitude	fx_animalslash,fx_f5_flashreincarnation		
Grimrock.UnitAttackedFX	UnitAttackedFX	Grimrock	fxCollisionSparksGreen,fxLightningHitGreen,fxElectricalGroundUpGreen		
Grincher.UnitAttackedFX	UnitAttackedFX	Grincher	fxCollisionSparksOrange,fxExplosionOrangeSmoke,fxExplosionOrangeSmoke		
Gro.UnitAttackedFX	UnitAttackedFX	Gro	fxImpactMediumOrange		
HailstoneHowler.UnitAttackedFX	UnitAttackedFX	HailstoneHowler	fxFrozenIceBlock,fxExplosionMediumBlueGround		
HailstonePrison.SpellCastFX	SpellCastFX	HailstonePrison	fx_f6_hailstoneprison		
HamonBlademaster.UnitAttackedFX	UnitAttackedFX	HamonBlademaster	fxImpactWhiteMedium,fxCollisionSparksBlue		ptcl_circleswirls
HankHart.UnitAttackedFX	UnitAttackedFX	HankHart	neutralCaptainHartProjectile,fxExplosionMediumIcyWhite,fxImpactRingVerticalOrange		ptcl_projectile_trail
HankHart.emitFX	emitFX	HankHart			ptcl_projectile_trail
HatchAnEgg.SpellAppliedFX	SpellAppliedFX	HatchAnEgg	fx_f5_earthsphere,fxSwirlRingsGreen,fxSwirlRingsGreen		ptcl_dot_square_green
HealingMystic.UnitAttackedFX	UnitAttackedFX	HealingMystic	fxCollisionSparksGreen,fxImpactWhiteMedium		
HearthSister.UnitAttackedFX	UnitAttackedFX	HearthSister	neutralCrossbonesProjectile,fxImpactMediumBlue,fxCollisionSparksBlue		ptcl_projectile_trail
HearthSister.emitFX	emitFX	HearthSister			ptcl_projectile_trail
Heartseeker.UnitAttackedFX	UnitAttackedFX	Heartseeker	f2CasterProjectile,fxImpactRingVerticalOrange,fxCollisionSparksOrange		ptcl_projectile_trail
Heartseeker.emitFX	emitFX	Heartseeker			ptcl_projectile_trail
HeavensEclipse.SpellCastFX	SpellCastFX	HeavensEclipse	fx_f2_heavenseclipse		
HollowGrovekeeper.UnitAttackedFX	UnitAttackedFX	HollowGrovekeeper	fxElectricalGroundUpBlue,fxPlasmaBlueHorizontal		
HolyImmolation.SpellCastFX	SpellCastFX	HolyImmolation	fxHeavensStrike,fx_vortexswirl,fx_f1_holyimmolation		
HomeostaticRebuke.SpellCastFX	SpellCastFX	HomeostaticRebuke	fx_beamfire,fx_f5_kinectequilibrium		
HorrificVisage.SpellCastFX	SpellCastFX	HorrificVisage	fx_multislash_full,fx_f4_darkfiresacrifice		
IceAge.SpellCastFX	SpellCastFX	IceAge	fx_f6_winterswake		
IceCage.SpellAppliedFX	SpellAppliedFX	IceCage	fxFrozenIceBlock,fxTeleportBlueOrb		
IceDrake.UnitAttackedFX	UnitAttackedFX	IceDrake	fxCollisionSparksBlue,fxClawSlash		
IceDryad.UnitAttackedFX	UnitAttackedFX	IceDryad	fxCollisionSparksBlue,fxCollisionSparksBlue		
Infest.SpellCastFX	SpellCastFX	Infest	fxTeleportPurpleOrb,fx_f4_nethersummoning,fx_f4_darkfiretransformation		
InkhornGaze.SpellCastFX	SpellCastFX	InkhornGaze	fxTeleportPurpleOrb,fxCrossSlash		
InnerFocus.SpellCastFX	SpellCastFX	InnerFocus	fx_f2_innerfocus,fxBuffSimpleGold		
InnerOasis.SpellCastFX	SpellCastFX	InnerOasis	fx_f1_divinebond,fxCleanse,fxSwirlRingsBlue,fxBlueWaterSplash		
Invigoration.SpellAppliedFX	SpellAppliedFX	Invigoration	fxImpactGreenBig,fxImpactGreenSmall,fxImpactGreenSmall,fxImpactGreenSmall,fxImpactGreenSmall		
Invincible.SpellCastFX	SpellCastFX	Invincible	fxTeleportYellowOrb,fx_f1_warsurge		
IroncliffeGuardian.UnitAttackedFX	UnitAttackedFX	IroncliffeGuardian	fxElectricalGroundUpYellow,fxImpactRingVerticalOrange,fxImpactRingVerticalOrange		
IroncliffeHeart.SpellCastFX	SpellCastFX	IroncliffeHeart	fxTeleportYellowOrb,fxCleanse,fxEnergyHaloGround		
JadeOgre.UnitAttackedFX	UnitAttackedFX	JadeOgre	fxCollisionSparksRed,fxPlasmaRedVertical		
JaxTruesight.UnitAttackedFX	UnitAttackedFX	JaxTruesight	neutralJaxTruesightProjectile,fxCollisionSparksBlue,fxPlasmaBlueHorizontal		ptcl_projectile_trail
JaxTruesight.emitFX	emitFX	JaxTruesight			ptcl_projectile_trail
Jaxi.UnitAttackedFX	UnitAttackedFX	Jaxi	neutralJaxTruesightProjectile,fxCollisionSparksBlue,fxPlasmaBlueHorizontal		ptcl_projectile_trail
Jaxi.emitFX	emitFX	Jaxi			ptcl_projectile_trail
Joseki.SpellCastFX	SpellCastFX	Joseki	fx_fireslash,fx_fireslash		
KageLightning.SpellAppliedFX	SpellAppliedFX	KageLightning	fx_f2_backstab		
KaidoAssassin.UnitAttackedFX	UnitAttackedFX	KaidoAssassin	fxImpactWhiteMedium,fxCollisionSparksRed		
KaraWinterblade.UnitAttackedFX	UnitAttackedFX	KaraWinterblade	fxBubbleEnergySootGround,fxImpactRingVerticalWhite		
KeeperOfTheVale.UnitAttackedFX	UnitAttackedFX	KeeperOfTheVale	fxImpactMediumBlue,fxCollisionSparksBlue,fxElectricalGroundUpBlue		
KenshoVortex.SpellCastFX	SpellCastFX	KenshoVortex	fx_f2_spiraltechnique02,fx_tornadoswirl		
KeshraiFanblade.UnitAttackedFX	UnitAttackedFX	KeshraiFanblade	fxCollisionSparksRed,fxClawSlash		
Khymera.UnitAttackedFX	UnitAttackedFX	Khymera	fxCollisionSparksOrange,fxExplosionOrangeSmoke,fxExplosionOrangeSmoke,fxExplosionOrangeSmoke,fxExplosionOrangeSmoke		
KiBeholder.UnitAttackedFX	UnitAttackedFX	KiBeholder	fxExplosionBigBall_MetalSlug		
KillTarget.SpellAppliedFX	SpellAppliedFX	KillTarget	fxFireTornado,fx_slashfrenzy,fxSmokeGround		
KillTargetWithRanged.SpellAppliedFX	SpellAppliedFX	KillTargetWithRanged	fxFireTornado,fxFaerieFireRed,fxSmokeGround		
KillingEdge.SpellCastFX	SpellCastFX	KillingEdge	fxFireTornado,fx_f2_killingedge		
KinematicProjection.SpellCastFX	SpellCastFX	KinematicProjection	fx_f3_starsfury,fxTeleportRecallWhite		
KineticEquilibrium.SpellCastFX	SpellCastFX	KineticEquilibrium	fx_f5_kinectequilibrium		
KineticSurge.SpellCastFX	SpellCastFX	KineticSurge	fx_f6_bbs_kinectsurge		
Kiyomori.SpellAppliedFX	SpellAppliedFX	Kiyomori	fx_f1_truestrike		
Klaxon.UnitAttackedFX	UnitAttackedFX	Klaxon	fxCollisionSparksBlue		
Knucklestorm.SpellCastFX	SpellCastFX	Knucklestorm	fx_multislash_intro,fxBladestorm,fxBladestorm		
KoanOfHorns.SpellCastFX	SpellCastFX	KoanOfHorns	fx_f2_koanofhorns		
Kolossus.UnitAttackedFX	UnitAttackedFX	Kolossus	fxCollisionSparksGreen,fxLightningHitGreen,fxElectricalGroundUpGreen		
Kotetsu.SpellCastFX	SpellCastFX	Kotetsu	fx_f1_truestrike,fx_f2_backstab		
Kujata.UnitAttackedFX	UnitAttackedFX	Kujata	fxCollisionSparksGreen,fxLightningHitGreen,fx_slashfrenzy,fxImpactWhiteMedium		
LaceratingFrost.SpellCastFX	SpellCastFX	LaceratingFrost	fxFrozenIceBlock,fxFrozenIceBlock,fx_multislash_full		
LadyLocke.UnitAttackedFX	UnitAttackedFX	LadyLocke	fxCollisionSparksBlue,fxCollisionSparksBlue,fxExplosionMediumBlueGround		
LanternFox.UnitAttackedFX	UnitAttackedFX	LanternFox	fxCollisionSparksRed,fxCollisionSparksRed,fxCollisionSparksOrange,fxFaerieFireRed		
LastingJudgement.SpellCastFX	SpellCastFX	LastingJudgement	fx_f1_lasting_judgment,fxYellowTeleporterBeam		
LavaLance.SpellCastFX	SpellCastFX	LavaLance	fxFireTornado,fxSearingChasm		
LesserWaterball.SpellCastFX	SpellCastFX	LesserWaterball	fxTeleportBlueOrb		
LessonOfCourage.SpellAppliedFX	SpellAppliedFX	LessonOfCourage	fxImpactBlueMed,fxImpactBlueMed,fxImpactBlueBig		
LessonOfPower.SpellCastFX	SpellCastFX	LessonOfPower	fxClawSlash,fxClawSlash		
LessonOfWisdom.SpellCastFX	SpellCastFX	LessonOfWisdom	fxSwirlRingsGreen,fxImpactGreenBig		
Letigress.UnitAttackedFX	UnitAttackedFX	Letigress	neutralLeTigressProjectile,fxImpactBigOrange,fxCollisionSparksOrange		ptcl_projectile_trail
Letigress.emitFX	emitFX	Letigress			ptcl_projectile_trail
LifeCoil.SpellCastFX	SpellCastFX	LifeCoil	fxEnergyHaloGround,fxYellowTeleporterBeam		
Lifestream.SpellCastFX	SpellCastFX	Lifestream	fxYellowTeleporterBeam,fxTeleportRecall		
Lightbender.UnitAttackedFX	UnitAttackedFX	Lightbender	fxCollisionSparksRed,fxElectricalGroundUpRed		
Lightchaser.UnitAttackedFX	UnitAttackedFX	Lightchaser	fxTeleportOrangeOrb,f1CasterProjectile		
LightningBeetle.UnitAttackedFX	UnitAttackedFX	LightningBeetle	fxCollisionSparksBlue,fxPlasmaBlueVertical		
LightningBlitz.SpellCastFX	SpellCastFX	LightningBlitz	fxExplosionMediumBlueGround,fxPlasmaBlueVertical		
LightningSister.UnitAttackedFX	UnitAttackedFX	LightningSister	fxExplosionBigBall_MetalSlug		
LionheartBlessing.SpellCastFX	SpellCastFX	LionheartBlessing	fx_f1_lionheartblessing		
Lionize.SpellCastFX	SpellCastFX	Lionize	fx_f1_lionheartblessing		
LivingFlame.SpellCastFX	SpellCastFX	LivingFlame	fx_beamfire,fxFireTornado		
LostInTheDesert.SpellAppliedFX	SpellAppliedFX	LostInTheDesert	fx_ringswirl,fxSandTileSpawn		
LucentBeam.SpellCastFX	SpellCastFX	LucentBeam	fx_beamlaser,fxYellowTeleporterBeam,fxHeavensStrike		
LurkingFear.SpellCastFX	SpellCastFX	LurkingFear	fx_beamfire,fx_f4_darkfiresacrifice		
LuxIgnis.UnitAttackedFX	UnitAttackedFX	LuxIgnis	neutralLuxIgnisProjectile,fxImpactBigOrange,fxCollisionSparksOrange,fxImpactRingVerticalOrange		ptcl_projectile_trail
LuxIgnis.emitFX	emitFX	LuxIgnis			ptcl_projectile_trail
LysianBrawler.UnitAttackedFX	UnitAttackedFX	LysianBrawler	fxSearingChasm,fxCollisionSparksOrange		
Maelstrom.SpellCastFX	SpellCastFX	Maelstrom	fx_f3_entropicdecay,fx_f5_earthsphere_orange		
MageOfFourWinds.UnitAttackedFX	UnitAttackedFX	MageOfFourWinds	fxPlasmaRedVertical		
Magnetize.SpellCastFX	SpellCastFX	Magnetize	fxBladestorm,fxYellowTeleporterBeam,fxBuffSimpleGold		
MakantorWarbeast.UnitAttackedFX	UnitAttackedFX	MakantorWarbeast	fxCollisionSparksGreen,fx_slashfrenzy,fxClawSlash,fxClawSlash		
Malice.SpellAppliedFX	SpellAppliedFX	Malice	fx_f4_bbs_malice		
ManaDeathgrip.SpellCastFX	SpellCastFX	ManaDeathgrip	fxTeleportBlueOrb		
ManaVortex.SpellCastFX	SpellCastFX	ManaVortex	fxImpactRedBig,fx_f2_manavortex,fxExplosionGroundSmokeSwirl		
Manaforger.UnitAttackedFX	UnitAttackedFX	Manaforger	fxCollisionSparksOrange		
Mandrake.UnitAttackedFX	UnitAttackedFX	Mandrake	fxCollisionSparksGreen,fxLightningHitGreen,fxImpactGreenMed,fxImpactGreenMed,fxImpactMediumOrange		
MarchingOrders.SpellAppliedFX	SpellAppliedFX	MarchingOrders	FloatingShield,FloatingShield,ForceField		
MarkOfSolitude.SpellCastFX	SpellCastFX	MarkOfSolitude	fx_f6_markofsolitude,fxSwirlRingsBlue		
Martyrdom.SpellCastFX	SpellCastFX	Martyrdom	fx_f1_martyrdom,fxYellowTeleporterBeam		
MassFlight.SpellCastFX	SpellCastFX	MassFlight	fx_f2_phoenixfire		
Maw.UnitAttackedFX	UnitAttackedFX	Maw	fxCollisionSparksGreen,fxImpactMediumOrange		
MechProgress.SpellCastFX	SpellCastFX	MechProgress	fx_beamlaser,fxBuffSimpleGold,fxEnergyHaloGround		
Mechaz0r.UnitAttackedFX	UnitAttackedFX	Mechaz0r	neutralMechaz0rSuperProjectile,fxImpactBigOrange,fxCollisionSparksRed		ptcl_projectile_trail
Mechaz0r.emitFX	emitFX	Mechaz0r			ptcl_projectile_trail
Mechaz0rCannon.UnitAttackedFX	UnitAttackedFX	Mechaz0rCannon	neutralMechaz0rCannonProjectile,fxImpactBigOrange,fxCollisionSparksRed		ptcl_projectile_trail
Mechaz0rCannon.emitFX	emitFX	Mechaz0rCannon			ptcl_projectile_trail
Mechaz0rChassis.UnitAttackedFX	UnitAttackedFX	Mechaz0rChassis	fxCollisionSparksBlue,fxCollisionSparksBlue		
Mechaz0rHelm.UnitAttackedFX	UnitAttackedFX	Mechaz0rHelm	fxCollisionSparksBlue,fxCollisionSparksBlue		
Mechaz0rSword.UnitAttackedFX	UnitAttackedFX	Mechaz0rSword	fxCollisionSparksOrange,fx_slashfrenzy		
Mechaz0rWings.UnitAttackedFX	UnitAttackedFX	Mechaz0rWings	fxCollisionSparksBlue,fxCollisionSparksBlue		
Meditate.SpellCastFX	SpellCastFX	Meditate	fx_f2_ancestralpact,fx_f2_manavortex,fxExplosionGroundSmokeSwirl		
Mesmerize.SpellCastFX	SpellCastFX	Mesmerize	fx_f6_mesmerize,fxTendrilsGreen,fxSwirlRingsBlue		
Metalmeld.SpellCastFX	SpellCastFX	Metalmeld	fxElectricalGroundUpYellow,fxElectricalGroundUpYellow,fxArtifactBreak		
Metamorphosis.SpellAppliedFX	SpellAppliedFX	Metamorphosis	fx_f5_manaburn		
MindSteal.SpellCastFX	SpellCastFX	MindSteal	fx_f5_mindsteal		
Mindwarper.UnitAttackedFX	UnitAttackedFX	Mindwarper	fxCollisionSparksOrange,fxExplosionOrangeSmoke		
MiniJax.UnitAttackedFX	UnitAttackedFX	MiniJax	neutralMiniJaxProjectile,fxImpactMediumBlue,fxPlasmaBlueHorizontal		ptcl_projectile_trail
MiniJax.emitFX	emitFX	MiniJax			ptcl_projectile_trail
MiniMagmar.UnitAttackedFX	UnitAttackedFX	MiniMagmar	fxCollisionSparksGreen,fxLightningHitGreen,fxLightningHitGreen		
MirkbloodDevourer.UnitAttackedFX	UnitAttackedFX	MirkbloodDevourer	fxPlasmaBlueHorizontal,fxImpactRingVerticalWhite		
MirrorMaster.UnitAttackedFX	UnitAttackedFX	MirrorMaster	fxCollisionSparksOrange,fxPlasmaBlueVertical,fxExplosionMediumBlueGround		
MirrorMeld.SpellCastFX	SpellCastFX	MirrorMeld	fxTeleportOrangeOrb		
MistDragonSeal.SpellCastFX	SpellCastFX	MistDragonSeal	fxPlasmaBlueVertical,fx_f2_mistdragonseal,fxElectricalGroundUpBlue,fxSmokeGround		
MistWalking.SpellAppliedFX	SpellAppliedFX	MistWalking	fxExplosionGroundSmokeSwirl,fx_f2_teleportsmoke,fxSmokeGround		
MitoticInduction.SpellCastFX	SpellCastFX	MitoticInduction	f1CasterProjectile,fx_f5_earthsphere		
ModifierAntiMagicField.ModifierFX	ModifierFX	ModifierAntiMagicField	fxDistortionHexShield		
ModifierBackstab.ModifierTriggeredTargetFX	ModifierTriggeredTargetFX	ModifierBackstab	fx_f2_backstab		
ModifierCollectibleBonusMana.ModifierFX	ModifierFX	ModifierCollectibleBonusMana	fxDistortionWaterBubble		ptcl_manaswirl
ModifierDispel.ModifierAppliedFX	ModifierAppliedFX	ModifierDispel	fxCleanse,fxSwirlRingsBlue		ptcl_circleswirls
ModifierDoomed.ModifierFX	ModifierFX	ModifierDoomed	fx_Doomed		
ModifierDoomed2.ModifierFX	ModifierFX	ModifierDoomed2	fx_Doomed2		
ModifierDoomed3.ModifierFX	ModifierFX	ModifierDoomed3	fx_Doomed3		
ModifierEmblem.ModifierAppliedFX	ModifierAppliedFX	ModifierEmblem	fxSummonMythron		
ModifierForcefieldAbsorb.ModifierFX	ModifierFX	ModifierForcefieldAbsorb			ptcl_force_field
ModifierFrenzy.ModifierTriggeredSourceFX	ModifierTriggeredSourceFX	ModifierFrenzy	fxBladestorm,fxClawSlash,fxClawSlash		
ModifierGenericBuff.ModifierTriggeredTargetFX	ModifierTriggeredTargetFX	ModifierGenericBuff	fxBuffSimpleGold,fxSwirlRingsGreen		
ModifierGenericChain.ModifierTriggeredFX	ModifierTriggeredFX	ModifierGenericChain	fxSiphon,fxExplosionMediumIcyWhite		ptcl_siphon
ModifierGenericChain.emitFX	emitFX	ModifierGenericChain			ptcl_siphon
ModifierGenericChainLightning.ModifierTriggeredFX	ModifierTriggeredFX	ModifierGenericChainLightning	fxChainLightningBlue,fxExplosionMediumIcyWhite		
ModifierGenericChainLightning.impactFX	impactFX	ModifierGenericChainLightning	fxExplosionMediumIcyWhite		
ModifierGenericChainLightningRed.ModifierTriggeredFX	ModifierTriggeredFX	ModifierGenericChainLightningRed	fxChainLightningRed,fxImpactBigOrange		
ModifierGenericChainLightningRed.impactFX	impactFX	ModifierGenericChainLightningRed	fxImpactBigOrange		
ModifierGenericDamage.ModifierTriggeredFX	ModifierTriggeredFX	ModifierGenericDamage	neutralMechaz0rSuperProjectile,fxImpactBigOrange,fxCollisionSparksRed		ptcl_projectile_trail
ModifierGenericDamage.emitFX	emitFX	ModifierGenericDamage			ptcl_projectile_trail
ModifierGenericDamageEnergySmall.ModifierTriggeredFX	ModifierTriggeredFX	ModifierGenericDamageEnergySmall	neutralMechaz0rCannonProjectile,fxImpactBigOrange,fxCollisionSparksRed		ptcl_projectile_trail
ModifierGenericDamageEnergySmall.emitFX	emitFX	ModifierGenericDamageEnergySmall			ptcl_projectile_trail
ModifierGenericDamageFire.ModifierTriggeredFX	ModifierTriggeredFX	ModifierGenericDamageFire	neutralSwornAvengerProjectile,fxImpactBigOrange,fxExplosionOrangeSmoke,fxCollisionSparksOrange		ptcl_projectile_trail
ModifierGenericDamageFire.emitFX	emitFX	ModifierGenericDamageFire			ptcl_projectile_trail
ModifierGenericDamageIce.ModifierTriggeredFX	ModifierTriggeredFX	ModifierGenericDamageIce	neutralCrossbonesProjectile,fxImpactMediumBlue,fxCollisionSparksBlue		ptcl_projectile_trail
ModifierGenericDamageIce.emitFX	emitFX	ModifierGenericDamageIce			ptcl_projectile_trail
ModifierGenericDamageNearby.ModifierTriggeredSourceFX	ModifierTriggeredSourceFX	ModifierGenericDamageNearby	fxFaerieFireRed,fx_slashfrenzy		
ModifierGenericDamageNearbyShadow.ModifierTriggeredSourceFX	ModifierTriggeredSourceFX	ModifierGenericDamageNearbyShadow	fx_f4_voidpulse		
ModifierGenericDamageSmall.ModifierTriggeredFX	ModifierTriggeredFX	ModifierGenericDamageSmall	f2CasterProjectile,fxImpactRingVerticalOrange,fxCollisionSparksOrange		ptcl_projectile_trail
ModifierGenericDamageSmall.emitFX	emitFX	ModifierGenericDamageSmall			ptcl_projectile_trail
ModifierGenericKill.ModifierTriggeredTargetFX	ModifierTriggeredTargetFX	ModifierGenericKill	fxCrossSlash		
ModifierImmunity.ModifierFX	ModifierFX	ModifierImmunity			ptcl_phalanx
ModifierInfest.ModifierFX	ModifierFX	ModifierInfest	fx_deathplagueicon		
ModifierInvulnerable.ModifierFX	ModifierFX	ModifierInvulnerable			ptcl_force_field_blue
ModifierMyAttackWatchGamble.ModifierTriggeredFX	ModifierTriggeredFX	ModifierMyAttackWatchGamble	neutralGamblerProjectile,fxImpactBigOrange,fxCollisionSparksOrange		ptcl_projectile_trail
ModifierMyAttackWatchGamble.emitFX	emitFX	ModifierMyAttackWatchGamble			ptcl_projectile_trail
ModifierSecondWind.ModifierTriggeredFX	ModifierTriggeredFX	ModifierSecondWind	fx_f5_boundedlife,fx_f5_manaburn,fxYellowTeleporterBeam		
ModifierStunnedVanar.ModifierAppliedFX	ModifierAppliedFX	ModifierStunnedVanar	fx_flashfreeze_appear		
Modifiers.ModifierTriggeredTargetFX	ModifierTriggeredTargetFX	Modifiers	ForceField		
Moebius.UnitAttackedFX	UnitAttackedFX	Moebius	fxSearingChasm,fxExplosionMediumBlueGround		
Mogwai.UnitAttackedFX	UnitAttackedFX	Mogwai	fxCollisionSparksBlue,fxPlasmaBlueHorizontal,fxImpactRingVerticalWhite		
MoldingEarth.SpellCastFX	SpellCastFX	MoldingEarth	fx_f5_tremor,fx_bouldersphere		
MolokiHuntress.UnitAttackedFX	UnitAttackedFX	MolokiHuntress	fxLightningHitGreen,fxElectricalGroundUpGreen		
MonolithicVision.SpellCastFX	SpellCastFX	MonolithicVision	fx_f3_dominatewill		
Munch.SpellAppliedFX	SpellAppliedFX	Munch	fx_f4_soulshatterpact,fxShadowCreepSpawn		
Murasame.SpellAppliedFX	SpellAppliedFX	Murasame	fx_f1_truestrike,fxBladestorm,fxBladestorm		
NaturalSelection.SpellCastFX	SpellCastFX	NaturalSelection	fx_f5_manaburn,fx_f5_naturalselection		
Necroseer.UnitAttackedFX	UnitAttackedFX	Necroseer	fxPlasmaBlueHorizontal,fxFaerieFirePurple,fxSwirlRingsBlue,fxExplosionGroundSmokeSwirl,fxSmokeGround		
NecroticSphere.SpellAppliedFX	SpellAppliedFX	NecroticSphere	fx_f4_nethersummoning,fxTeleportPurpleOrb		
NetherSummoning.SpellCastFX	SpellCastFX	NetherSummoning	fx_f4_soulshatterpact		
Neurolink.SpellCastFX	SpellCastFX	Neurolink	fxTeleportYellowOrb,fx_f3_fountainofyouth		
Neutral.UnitAttackedFX	UnitAttackedFX	Neutral	neutralSwornAvengerProjectile,fxImpactBigOrange,fxExplosionOrangeSmoke,fxCollisionSparksOrange		ptcl_projectile_trail
Neutral.UnitSpawnFX	UnitSpawnFX	Neutral	fxTeleportRecallBlue,fxSwirlRingsBlue,fxSmokeGround		
Neutral.emitFX	emitFX	Neutral			ptcl_projectile_trail
NightfallMechanyst.UnitAttackedFX	UnitAttackedFX	NightfallMechanyst	fxCollisionSparksOrange,fxImpactRingVerticalWhite,fxPlasmaBlueVertical		
NightsorrowAssassin.UnitAttackedFX	UnitAttackedFX	NightsorrowAssassin	fxImpactWhiteMedium,fxCollisionSparksPurple		
Nimbus.UnitAttackedFX	UnitAttackedFX	Nimbus	fxCollisionSparksBlue,fxElectricalGroundUpBlue,fxElectricalGroundUpBlue,fxExplosionMediumBlueGround		
Obliterate.SpellCastFX	SpellCastFX	Obliterate	fx_f4_obliterate		
ObscuringBlow.SpellCastFX	SpellCastFX	ObscuringBlow	fx_f2_backstab,fx_fireslash		
OnyxBearSeal.SpellCastFX	SpellCastFX	OnyxBearSeal	fxPlasmaRedVertical,fx_f2_onyxbearseal,fxElectricalGroundUpYellow,fxSmokeGround		
OnyxScorpion.UnitAttackedFX	UnitAttackedFX	OnyxScorpion	fxCollisionSparksBlue,fxClawSlash,fxClawSlash		
OrbWeaver.UnitAttackedFX	UnitAttackedFX	OrbWeaver	fxCollisionSparksOrange,fxImpactRingVerticalWhite		
Oserix.UnitAttackedFX	UnitAttackedFX	Oserix	fxCollisionSparksOrange,fxImpactRingVerticalWhite,fxPlasmaBlueVertical		
Overload.SpellAppliedFX	SpellAppliedFX	Overload	fx_f5_bbs_overload		
OwlbeastSage.UnitAttackedFX	UnitAttackedFX	OwlbeastSage	fxElectricalGroundUpBlue,fxExplosionMediumBlueGround		
Paddo.UnitAttackedFX	UnitAttackedFX	Paddo	fxCollisionSparksGreen,fxLightningHitGreen,fxLightningHitGreen		
PainfulPluck.SpellCastFX	SpellCastFX	PainfulPluck	fx_f4_shadownova		
Pandatentiary.SpellCastFX	SpellCastFX	Pandatentiary	fxPlasmaRedVertical,fx_f2_onyxbearseal,fxElectricalGroundUpYellow,fxSmokeGround		
Pandora.UnitAttackedFX	UnitAttackedFX	Pandora	fxCollisionSparksOrange,fxExplosionOrangeSmoke,fxExplosionOrangeSmoke		
PandoraMinionBlaze.UnitAttackedFX	UnitAttackedFX	PandoraMinionBlaze	fxCollisionSparksOrange,fxExplosionOrangeSmoke,fxExplosionOrangeSmoke,fxClawSlash		
PandoraMinionCloud.UnitAttackedFX	UnitAttackedFX	PandoraMinionCloud	fxCollisionSparksBlue,fxClawSlash		
PandoraMinionFlash.UnitAttackedFX	UnitAttackedFX	PandoraMinionFlash	fxCollisionSparksRed,fxClawSlash,fxFaerieFireRed		
PandoraMinionSinker.UnitAttackedFX	UnitAttackedFX	PandoraMinionSinker	fxCollisionSparksPurple,fxClawSlash,fxFaerieFirePurple		
PandoraMinionZap.UnitAttackedFX	UnitAttackedFX	PandoraMinionZap	neutralSwornAvengerProjectile,fxImpactBigOrange,fxExplosionOrangeSmoke,fxCollisionSparksOrange		ptcl_projectile_trail
PandoraMinionZap.emitFX	emitFX	PandoraMinionZap			ptcl_projectile_trail
Pantheran.UnitAttackedFX	UnitAttackedFX	Pantheran	fxCollisionSparksBlue,fxExplosionMediumBlueGround		
PetalFlurry.SpellCastFX	SpellCastFX	PetalFlurry	fx_f2_bbs_petalflurry		
Phalanxar.UnitAttackedFX	UnitAttackedFX	Phalanxar	fxCollisionSparksGreen,fxLightningHitGreen,fxLightningHitGreen,fxLightningHitGreen		
PhaseHound.UnitAttackedFX	UnitAttackedFX	PhaseHound	fxCollisionSparksBlue,fxClawSlash,fxClawSlash		
PhoenixBarrage.SpellAppliedFX	SpellAppliedFX	PhoenixBarrage	fx_f2_phoenixfire,fx_f2_phoenixfire,fx_ringswirl,fxFireTornado		
PhoenixFire.SpellAppliedFX	SpellAppliedFX	PhoenixFire	fx_f2_phoenixfire,fxFireTornado		
PiercingMantis.UnitAttackedFX	UnitAttackedFX	PiercingMantis	fx_slashfrenzy,fxCrossSlash		
PlanarFoundry.SpellAppliedFX	SpellAppliedFX	PlanarFoundry	fxTeleportRecallBlue,fxArtifactHit,fxArtifactHit		
PlanarScout.UnitAttackedFX	UnitAttackedFX	PlanarScout	fxExplosionMediumBlueGround		
PlasmaStorm.SpellCastFX	SpellCastFX	PlasmaStorm	fx_f5_kinectequilibrium		
Polarity.SpellAppliedFX	SpellAppliedFX	Polarity	fxSwirlRingsBlue,fxSwirlRingsBlue		
PortalGuardian.UnitAttackedFX	UnitAttackedFX	PortalGuardian	fxCollisionSparksOrange,fxImpactRingVerticalWhite		
PrimalBallast.SpellAppliedFX	SpellAppliedFX	PrimalBallast	fxYellowTeleporterBeam,fx_f5_flashreincarnation		
PrimordialGazer.UnitAttackedFX	UnitAttackedFX	PrimordialGazer	fxCollisionSparksGreen		
PrimusFist.UnitAttackedFX	UnitAttackedFX	PrimusFist	fxCollisionSparksBlue,fxFaerieFireBlue		
PrismaticGiant.UnitAttackedFX	UnitAttackedFX	PrismaticGiant	fxCollisionSparksBlue,fxCollisionSparksBlue,fxCollisionSparksBlue		
PrismaticIllusionist.UnitAttackedFX	UnitAttackedFX	PrismaticIllusionist	fxCollisionSparksBlue,fxExplosionMediumBlueGround		
Prisoner6.UnitAttackedFX	UnitAttackedFX	Prisoner6	fxChainLightningBlue,fxPlasmaBlueHorizontal,fxPlasmaBlueHorizontal,fxSmokeGround		
ProphetWhitePalm.UnitAttackedFX	UnitAttackedFX	ProphetWhitePalm	fxPlasmaBlueHorizontal,fxElectricalGroundUpBlue,fxPlasmaBlueHorizontal		
PsionicStrike.SpellAppliedFX	SpellAppliedFX	PsionicStrike	fx_f3_bbs_psyonicstrike		
Punish.SpellCastFX	SpellCastFX	Punish	fx_vortexswirl,fx_f4_deathfire_crescendo		
Pupabomb.SpellCastFX	SpellCastFX	Pupabomb	fxTeleportOrangeOrb,fx_f5_earthsphere_orange		
Purgatos.UnitAttackedFX	UnitAttackedFX	Purgatos	fxCollisionSparksRed,fxPlasmaRedVertical,fxPlasmaBlueVertical		
PutridMindflayer.UnitAttackedFX	UnitAttackedFX	PutridMindflayer	fxCollisionSparksOrange,fxClawSlash		
RadiantDragoon.UnitAttackedFX	UnitAttackedFX	RadiantDragoon	fxElectricalGroundUpBlue		
RashasCurse.SpellCastFX	SpellCastFX	RashasCurse	fxPlasmaBlueVertical,fx_f3_rashascurse,fxExplosionMediumBlueGround		
RazorSkin.SpellAppliedFX	SpellAppliedFX	RazorSkin	fxTendrilsGreen,fxLightningHitGreen		
Razorback.UnitAttackedFX	UnitAttackedFX	Razorback	fxClawSlash,fxClawSlash		
Reassemble.SpellAppliedFX	SpellAppliedFX	Reassemble	fxYellowTeleporterBeam,fxTeleportRecallWhite,fxExplosionGroundSmokeSwirl		
RedSynja.UnitAttackedFX	UnitAttackedFX	RedSynja	fxCollisionSparksBlue,fxClawSlash,fxClawSlash		
RefreshArtifacts.SpellAppliedFX	SpellAppliedFX	RefreshArtifacts	ForceField,fxBuffSimpleGold		
RepulsionBeast.UnitAttackedFX	UnitAttackedFX	RepulsionBeast	fxImpactRingVerticalWhite,fxCollisionSparksBlue		
RestoringLight.SpellCastFX	SpellCastFX	RestoringLight	fx_f1_sunbloom,fx_beamlaser		
RevaEventide.UnitAttackedFX	UnitAttackedFX	RevaEventide	fxClawSlash,fxClawSlash,fxImpactRingVerticalWhite		
Riddle.SpellCastFX	SpellCastFX	Riddle	fx_neutral_riddle		
RiteOfTheUndervault.SpellCastFX	SpellCastFX	RiteOfTheUndervault	fx_f4_riteundervault		
Roar.SpellAppliedFX	SpellAppliedFX	Roar	fx_f1_bbs_roar		
RockPulverizer.UnitAttackedFX	UnitAttackedFX	RockPulverizer	fxCollisionSparksOrange		
RogueWarden.UnitAttackedFX	UnitAttackedFX	RogueWarden	fxChainLightningBlue,fxPlasmaBlueHorizontal,fxPlasmaBlueHorizontal,fxSmokeGround		
Rook.UnitAttackedFX	UnitAttackedFX	Rook	fxExplosionBigBall_MetalSlug		
RubyRifter.UnitAttackedFX	UnitAttackedFX	RubyRifter	fxSearingChasm,fxExplosionMediumBlueGround		
SaberspineSeal.SpellCastFX	SpellCastFX	SaberspineSeal	fxPlasmaRedVertical,fx_fireslash,fx_f2_saberspineseal		
SaberspineTiger.UnitAttackedFX	UnitAttackedFX	SaberspineTiger	fxCollisionSparksOrange,fxClawSlash,fxClawSlash,fxClawSlash		
Sai.UnitAttackedFX	UnitAttackedFX	Sai	fxCollisionSparksGreen,fxImpactMediumOrange,fxImpactWhiteMedium		
SandHowler.UnitAttackedFX	UnitAttackedFX	SandHowler	fxCollisionSparksOrange,fxClawSlash,fxClawSlash		
SandSister.UnitAttackedFX	UnitAttackedFX	SandSister	fxCollisionSparksRed,fxExplosionBigBall_MetalSlug		
SandTrap.SpellCastFX	SpellCastFX	SandTrap	fxTeleportRecall,fxBuffSimpleGold,fxSmokeGround		
SapphireSeer.UnitAttackedFX	UnitAttackedFX	SapphireSeer	fxPlasmaBlueHorizontal,fxImpactRingVerticalWhite		
SarlacTheEternal.UnitAttackedFX	UnitAttackedFX	SarlacTheEternal	fxExplosionMediumBlueGround		
SaurianFinality.SpellAppliedFX	SpellAppliedFX	SaurianFinality	fxTeleportOrangeOrb,fx_f5_amplification,fx_f5_earthsphere		
ScarletViper.UnitAttackedFX	UnitAttackedFX	ScarletViper	fxCollisionSparksRed,fxClawSlash		
ScionessSajj.UnitAttackedFX	UnitAttackedFX	ScionessSajj	fxCollisionSparksOrange,fxPlasmaBlueVertical,fxElectricalGroundUpBlue		
ScionsFirstWish.SpellCastFX	SpellCastFX	ScionsFirstWish	fx_f3_scionsfirstwish		ptcl_pixelpuff
ScionsSecondWish.SpellCastFX	SpellCastFX	ScionsSecondWish	fx_f3_scionssecondwish,fxCleanse,fxSwirlRingsBlue		
ScionsThirdWish.SpellCastFX	SpellCastFX	ScionsThirdWish	fx_f3_scionsthirdwish,fxCleanse,fxCleanse		
SecondSelf.SpellCastFX	SpellCastFX	SecondSelf	fxTeleportOrangeOrb		
SeekerSquad.SpellCastFX	SpellCastFX	SeekerSquad	fx_f2_ancestralpact,fx_f2_teleportsmoke,fx_f2_teleportsmoke,fxSmokeGround		
SeekingEye.SpellCastFX	SpellCastFX	SeekingEye	fx_f5_bbs_seekingeye		
SeismicElemental.UnitAttackedFX	UnitAttackedFX	SeismicElemental	fxCollisionSparksBlue,fxCollisionSparksBlue		
Serpenti.UnitAttackedFX	UnitAttackedFX	Serpenti	fxCrossSlash,fx_slashfrenzy		
Shadow.UnitSpawnFX	UnitSpawnFX	Shadow	fxSmokeGround		
ShadowReflection.SpellCastFX	SpellCastFX	ShadowReflection	fx_f4_shadowreflection		
ShadowSister.UnitAttackedFX	UnitAttackedFX	ShadowSister	fxCollisionSparksRed,fxExplosionBigBall_MetalSlug		
ShadowStalk.SpellCastFX	SpellCastFX	ShadowStalk	fx_f4_wraithlingfury		
ShadowWaltz.SpellCastFX	SpellCastFX	ShadowWaltz	fxBladestorm,fxCrossSlash,fxBladestorm		
ShadowWatcher.UnitAttackedFX	UnitAttackedFX	ShadowWatcher	neutralMechaz0rSuperProjectile,fxImpactBigOrange,fxCollisionSparksRed		
ShadowWatcher.impactFX	impactFX	ShadowWatcher	fxImpactBigOrange,fxCollisionSparksRed		
Shadowspawn.SpellAppliedFX	SpellAppliedFX	Shadowspawn	fx_f4_bbs_shadowspawn		
SharianShadowdancer.UnitAttackedFX	UnitAttackedFX	SharianShadowdancer	fxImpactWhiteMedium,fxCrossSlash,fxCollisionSparksPurple		
Shatter.SpellCastFX	SpellCastFX	Shatter	fx_f5_earthsphere_blue,fxFrozenIceBlock		
Shiro.UnitAttackedFX	UnitAttackedFX	Shiro	fxPlasmaBlueHorizontal,fxElectricalGroundUpBlue		
SilitharElder.UnitAttackedFX	UnitAttackedFX	SilitharElder	fxCollisionSparksBlue,fxElectricalGroundUpBlue,fxElectricalGroundUpBlue,fxElectricalGroundUpBlue		
SilverguardKnight.UnitAttackedFX	UnitAttackedFX	SilverguardKnight	fxExplosionMediumBlueGround,fxCollisionSparksBlue		
SilverguardSquire.UnitAttackedFX	UnitAttackedFX	SilverguardSquire	fxCollisionSparksOrange,fxCollisionSparksOrange,fxImpactMediumOrange		
SilvertongueCorsair.UnitAttackedFX	UnitAttackedFX	SilvertongueCorsair	fxCollisionSparksBlue,fxClawSlash		
SiphonEnergy.SpellCastFX	SpellCastFX	SiphonEnergy	fxCollisionSparksOrange,fxCollisionSparksBlue		
SkyBurial.SpellCastFX	SpellCastFX	SkyBurial	fx_f1_decimate,fxSmokeGround		
SkyPhalanx.SpellCastFX	SpellCastFX	SkyPhalanx	fx_f1_skyphalanx		
SkyrockGolem.UnitAttackedFX	UnitAttackedFX	SkyrockGolem	fxCollisionSparksOrange,fxImpactWhiteMedium		
Skywing.UnitAttackedFX	UnitAttackedFX	Skywing	fxCollisionSparksRed,fxElectricalGroundUpBlue,fxElectricalGroundUpRed		
SnowElemental.UnitAttackedFX	UnitAttackedFX	SnowElemental	neutralCrossbonesProjectile,fxImpactMediumBlue,fxCollisionSparksBlue		ptcl_projectile_trail
SnowElemental.emitFX	emitFX	SnowElemental			ptcl_projectile_trail
SnowPatrol.SpellCastFX	SpellCastFX	SnowPatrol	fxFrozenIceBlock,fx_f6_mesmerize		
Sojourner.UnitAttackedFX	UnitAttackedFX	Sojourner	fxCollisionSparksBlue		
Solarius.UnitAttackedFX	UnitAttackedFX	Solarius	fxCollisionSparksRed,fxExplosionBigBall_MetalSlug		
Solpiercer.UnitAttackedFX	UnitAttackedFX	Solpiercer	f1BacklineArcherProjectile,fxImpactBigOrange,fxCollisionSparksOrange		ptcl_projectile_trail
Solpiercer.emitFX	emitFX	Solpiercer			ptcl_projectile_trail
SoulshatterPact.SpellCastFX	SpellCastFX	SoulshatterPact	fx_f4_soulshatterpact		
SpectralRevenant.UnitAttackedFX	UnitAttackedFX	SpectralRevenant	fxCollisionSparksPurple,fxClawSlash,fxClawSlash		
SpellDamage.SpellAppliedFX	SpellAppliedFX	SpellDamage	fxPlasmaRedVertical,fxFireTornado,fxFaerieFireRed,fxSmokeGround		
Spelljammer.UnitAttackedFX	UnitAttackedFX	Spelljammer	fxCollisionSparksOrange,fxElectricalGroundUpRed		
Spellspark.UnitAttackedFX	UnitAttackedFX	Spellspark	fxCollisionSparksOrange,fxExplosionOrangeSmoke,fxExplosionOrangeSmoke,fxExplosionOrangeSmoke		
SphereOfDarkness.SpellAppliedFX	SpellAppliedFX	SphereOfDarkness	fxTeleportPurpleOrb		
SpiralCounter.SpellCastFX	SpellCastFX	SpiralCounter	fx_f2_spiraltechnique02		
SpiralTechnique.SpellCastFX	SpellCastFX	SpiralTechnique	fx_fireslash,fx_fireslash,fx_f2_spiraltechnique02,fx_f2_eightgates_teal		
SpiritHarvester.UnitAttackedFX	UnitAttackedFX	SpiritHarvester	fxCollisionSparksGreen,fxClawSlash,fxClawSlash		
SpiritoftheWild.SpellCastFX	SpellCastFX	SpiritoftheWild	fx_f6_spiritofthewild		
SpottedDragonlark.UnitAttackedFX	UnitAttackedFX	SpottedDragonlark	fxCollisionSparksOrange,fxClawSlash,fxClawSlash		
Starhorn.UnitAttackedFX	UnitAttackedFX	Starhorn	fxCollisionSparksGreen,fxLightningHitGreen,fxLightningHitGreen		
StarsFury.SpellAppliedFX	SpellAppliedFX	StarsFury	fx_f3_starsfury,fxSmokeGround		
SteadfastFormation.SpellCastFX	SpellCastFX	SteadfastFormation	fx_f1_aurynnexus		
StoneToSpears.SpellCastFX	SpellCastFX	StoneToSpears	fxCollisionSparksOrange,fxCollisionSparksOrange,fxSmokeGround		
StormKage.UnitAttackedFX	UnitAttackedFX	StormKage	fxElectricalGroundUpRed,fxPlasmaRedVertical		
StormmetalGolem.UnitAttackedFX	UnitAttackedFX	StormmetalGolem	fxClawSlash,fxSmokeGround,fxExplosionMediumBlueGround		
SunBloom.SpellCastFX	SpellCastFX	SunBloom	fx_f1_sunbloom		
SunElemental.UnitAttackedFX	UnitAttackedFX	SunElemental	fxCollisionSparksOrange,fxExplosionOrangeSmoke,fxExplosionOrangeSmoke,fxExplosionOrangeSmoke		
SunSeer.UnitAttackedFX	UnitAttackedFX	SunSeer	fxExplosionBigBall_MetalSlug,fxExplosionMediumBlueGround		
SunStrike.SpellCastFX	SpellCastFX	SunStrike	fxHeavensStrike,fxHeavensStrike,fx_f1_decimate		
SundropElixir.SpellAppliedFX	SpellAppliedFX	SundropElixir	fxBuffSimpleGold,fxImpactBigOrange		
SunforgeLancer.UnitAttackedFX	UnitAttackedFX	SunforgeLancer	fxCollisionSparksOrange,fxCollisionSparksOrange,fxCollisionSparksOrange,fxCollisionSparksOrange		
Sunriser.UnitAttackedFX	UnitAttackedFX	Sunriser	fxCollisionSparksBlue,fxCollisionSparksBlue		
SunsetParagon.UnitAttackedFX	UnitAttackedFX	SunsetParagon	fxCollisionSparksPurple,fxCrossSlash,fxCrossSlash		
SunsteelDefender.UnitAttackedFX	UnitAttackedFX	SunsteelDefender	fxHeavensStrike,fxSmokeGround		ptcl_pixelpuff
SunstoneTemplar.UnitAttackedFX	UnitAttackedFX	SunstoneTemplar	fxElectricalGroundUpYellow,fxCollisionSparksOrange		
SuntideMaiden.UnitAttackedFX	UnitAttackedFX	SuntideMaiden	fxTeleportYellowOrb,fxElectricalGroundUpYellow		
SuperiorMirage.SpellCastFX	SpellCastFX	SuperiorMirage	fx_f3_entropicdecay,fx_f3_blindscorch		
SwornAvenger.UnitAttackedFX	UnitAttackedFX	SwornAvenger	neutralSwornAvengerProjectile,fxImpactBigOrange,fxExplosionOrangeSmoke,fxCollisionSparksOrange		ptcl_projectile_trail
SwornAvenger.emitFX	emitFX	SwornAvenger			ptcl_projectile_trail
SwornDefender.UnitAttackedFX	UnitAttackedFX	SwornDefender	fxCollisionSparksBlue		
SwornSister.UnitAttackedFX	UnitAttackedFX	SwornSister	fxExplosionBigBall_MetalSlug		
SynapticArbitrage.SpellAppliedFX	SpellAppliedFX	SynapticArbitrage	fx_f3_drainmorale,fxTendrilsGreen		
SyvrelTheExile.UnitAttackedFX	UnitAttackedFX	SyvrelTheExile	neutralSyvrelProjectile,fxExplosionOrangeSmoke,fxImpactRingVerticalOrange		ptcl_projectile_trail
SyvrelTheExile.emitFX	emitFX	SyvrelTheExile			ptcl_projectile_trail
Tanahashi.SpellCastFX	SpellCastFX	Tanahashi	fx_f1_truestrike		
TectonicSpikes.SpellCastFX	SpellCastFX	TectonicSpikes	fx_f5_tremor,fx_f3_blast		
Tethermancer.UnitAttackedFX	UnitAttackedFX	Tethermancer	fxCollisionSparksRed,fxPlasmaBlueHorizontal,fxElectricalGroundUpBlue		
TheHighHand.UnitAttackedFX	UnitAttackedFX	TheHighHand	fxCollisionSparksBlue,fxPlasmaBlueVertical,fxPlasmaBlueVertical,fxPlasmaBlueVertical		
TheScientist.UnitAttackedFX	UnitAttackedFX	TheScientist	fxCollisionSparksBlue,fxPlasmaBlueVertical,fxPlasmaBlueVertical,fxPlasmaBlueVertical		
ThornNeedler.UnitAttackedFX	UnitAttackedFX	ThornNeedler	fxCollisionSparksBlue,fxClawSlash,fxClawSlash,fxImpactWhiteMedium		
ThumpingWave.SpellCastFX	SpellCastFX	ThumpingWave	fx_f5_mindsteal,fx_f5_manaburn		ptcl_circleswirls
Thunderbomb.SpellCastFX	SpellCastFX	Thunderbomb	fx_flamesphere,fx_electricsphere,fx_f2_backstab		
Tile.UnitDiedFX	UnitDiedFX	Tile	fxSwirlRingsBlue,fxCollisionSparksBlue		
Treant.UnitAttackedFX	UnitAttackedFX	Treant	fxCollisionSparksBlue,fxClawSlash		
Tremor.SpellCastFX	SpellCastFX	Tremor	fx_f5_tremor,fxSmokeGround		
TrueStrike.SpellAppliedFX	SpellAppliedFX	TrueStrike	fx_f1_truestrike,fxEnergyHaloGround		
TuskBoar.UnitAttackedFX	UnitAttackedFX	TuskBoar	fxDevour,BloodExplosionBig,fxImpactRingVerticalWhite		
TuskBoar.impactFX	impactFX	TuskBoar	BloodExplosionBig,fxImpactRingVerticalWhite		
TwilightMage.UnitAttackedFX	UnitAttackedFX	TwilightMage	neutralMercGrenadierProjectile,fxImpactBigOrange		
TwilightMage.impactFX	impactFX	TwilightMage	fxImpactBigOrange		
TwilightReiki.SpellCastFX	SpellCastFX	TwilightReiki	fx_f2_twilightreiki		
TwinStrike.SpellCastFX	SpellCastFX	TwinStrike	fxSmokeGround,fx_f2_twinstrike,fx_f2_twinstrike_part2,fxSmokeGround		
Ubo.UnitAttackedFX	UnitAttackedFX	Ubo	fxCollisionSparksGreen,fxElectricalGroundUpGreen		
UnfathomableRite.SpellCastFX	SpellCastFX	UnfathomableRite	fx_f4_riteundervault		
Unknown.ArtifactAppliedFX	ArtifactAppliedFX	Unknown	fxBuffSimpleGold,fxSwirlRingsBlue,fxSmokeGround		
Unknown.CardBurnFX	CardBurnFX	Unknown			ptcl_fireexplosion
Unknown.CardLegendaryPlayFX	CardLegendaryPlayFX	Unknown	fxSummonLegendary		
Unknown.CardRemoveFX	CardRemoveFX	Unknown	fxCrossSlash,fxBladestorm		
Unknown.ModifierFX	ModifierFX	Unknown	fx_flashfreeze_idle		
Unknown.ModifierRemovedFX	ModifierRemovedFX	Unknown	fx_flashfreeze_disappear		
Unknown.ModifierTriggeredSourceFX	ModifierTriggeredSourceFX	Unknown			ptcl_manaspring
Unknown.MoveFX	MoveFX	Unknown			ptcl_pixelteleport
Unknown.MoveTargetFX	MoveTargetFX	Unknown	fxTeleportRecall2,fxSwirlRingsBlue		
Unknown.SpawnSpecialFX	SpawnSpecialFX	Unknown	fxTeleportRecall2,fxSwirlRingsBlue,fxSmokeGround		
Unknown.SpellAppliedFX	SpellAppliedFX	Unknown	fxBladestorm,fxEnergyHaloGround,fxFireTornado,fxSmokeGround,fx_f5_earthsphere_blue,fx_fireslash,fx_fireslash,fxHeavensStrike,fxTeleportPurpleOrb,fx_f4_nethersummoning,fx_f4_voidpulse,fx_f4_nethersummoning,fx_f4_darkfiresacrifice,fx_f2_eightgates_purpleflame,fxChainLightningRed,fxPlasmaRedVertical,fx_f5_manaburn,fx_f3_blaststarfire,fxElectricalGroundUpBlue,fxShadowCreepSpawn,fx_f3_blast,fxSearingChasm,fxSmokeGround,fx_f3_starsfury,fxTeleportBlueOrb,fxFrozenIceBlock,fxHolyTileSpawn,fxYellowTeleporterBeam,fx_f1_decimate,fxFrozenIceBlock,fxBlueWaterSplash,fx_flashfreeze_appear,fxBlueWaterSplash,fx_flashfreeze_appear,FloatingShield,FloatingShield,fxBuffSimpleGold,fx_beamfire,fxFaerieFireDeepRed,fxImpactBigOrange,fx_beamtesla		
Unknown.SpellCastFX	SpellCastFX	Unknown	fxSmokeGround,fx_f1_decimate,fx_f5_flashreincarnation,fx_f5_naturalselection,fx_f6_bbs_warbird,fx_f4_darkfiretransformation,fxElectricalGroundUpYellow,fxElectricalGroundUpYellow,fxArtifactBreak		ptcl_pixelpuff
Unknown.UnitDamagedFX	UnitDamagedFX	Unknown	fxCollisionSparksOrange		
Unknown.UnitHealedFX	UnitHealedFX	Unknown	fxSwirlRingsGreen,fxSmokeGround		ptcl_dot_square_green
Unknown.UnitSpawnFX	UnitSpawnFX	Unknown	fxTeleportRecall,fxBladestorm,fxSmokeGround,fxTeleportRecall2,fxBladestorm,fxSmokeGround		
Unknown.impactFX	impactFX	Unknown	fxPlasmaRedVertical,fxImpactRingVerticalOrange,fxCollisionSparksOrange,fxImpactBigOrange,fxImpactBigOrange,fxCollisionSparksOrange,fxImpactBigOrange,fxCollisionSparksOrange,fxImpactMediumBlue,fxCollisionSparksBlue,fxImpactMediumBlue,fxCollisionSparksBlue,fxImpactBigOrange,fxExplosionOrangeSmoke,fxCollisionSparksOrange,fxPlasmaBlueHorizontal,fxImpactBigOrange,fxCollisionSparksRed,fxImpactBigOrange,fxCollisionSparksRed,fxImpactBigOrange,fxExplosionOrangeSmoke,fxCollisionSparksOrange,fxImpactBigOrange,fxExplosionOrangeSmoke,fxCollisionSparksOrange,fxCollisionSparksBlue,fxPlasmaBlueHorizontal,fxCollisionSparksBlue,fxPlasmaBlueHorizontal,fxImpactMediumBlue,fxPlasmaBlueHorizontal,fxPlasmaRedVertical,fxCollisionSparksOrange,fxFaerieFirePurple,fxPlasmaBlueHorizontal,fxImpactMediumBlue,fxCollisionSparksBlue,fxImpactBigOrange,fxExplosionOrangeSmoke,fxCollisionSparksOrange,fxImpactMediumBlue,fxCollisionSparksBlue,fxImpactBigOrange,fxCollisionSparksOrange,fxImpactRingVerticalOrange,fxExplosionOrangeSmoke,fxImpactRingVerticalOrange,fxExplosionMediumIcyWhite,fxImpactRingVerticalOrange,fxPlasmaBlueHorizontal,fxPlasmaBlueHorizontal,fxImpactBigOrange,fxCollisionSparksOrange,fxImpactBigOrange,fxCollisionSparksOrange,fxImpactBigOrange,fxCollisionSparksOrange,fxImpactBigOrange,fxCollisionSparksOrange,fxExplosionMediumIcyWhite,fxImpactBigOrange,fxCollisionSparksRed,fxImpactBigOrange,fxCollisionSparksRed,fxImpactRingVerticalOrange,fxCollisionSparksOrange,fxImpactBigOrange,fxCollisionSparksOrange,fxImpactMediumBlue,fxCollisionSparksBlue,fxImpactBigOrange,fxExplosionOrangeSmoke,fxCollisionSparksOrange		
UnleashTheEvil.SpellCastFX	SpellCastFX	UnleashTheEvil	fx_animalslash,fx_animalslash,fx_f4_consumingrebirth		
Unseven.UnitAttackedFX	UnitAttackedFX	Unseven	fxCollisionSparksBlue,fxImpactWhiteMedium		ptcl_circleswirls,ptcl_circleswirls
UnstableLeviathan.UnitAttackedFX	UnitAttackedFX	UnstableLeviathan	fxLightningHitGreen,fxClawSlash		
UpperHand.SpellCastFX	SpellCastFX	UpperHand	fxLightningHitGreen,fxSmokeGround,fxTendrilsGreen		
VaathsBrutality.SpellAppliedFX	SpellAppliedFX	VaathsBrutality	fxSearingChasm,fx_f5_manaburn		
ValeAscension.SpellAppliedFX	SpellAppliedFX	ValeAscension	fxHolyTileSpawn,fxYellowTeleporterBeam		
ValeHunter.UnitAttackedFX	UnitAttackedFX	ValeHunter	neutralTribalRanged1Projectile,fxImpactMediumBlue,fxCollisionSparksBlue		ptcl_projectile_trail
ValeHunter.emitFX	emitFX	ValeHunter			ptcl_projectile_trail
Vellumscry.SpellCastFX	SpellCastFX	Vellumscry	fx_f2_eightgates_purpleflame,fxSmokeGround		
VenomToth.UnitAttackedFX	UnitAttackedFX	VenomToth	fxCollisionSparksBlue,fxClawSlash,fxClawSlash,fxImpactWhiteMedium		
VerdentFulmination.SpellCastFX	SpellCastFX	VerdentFulmination	fx_f5_amplification,fxPrimalTileSpawn		
VespyrianMight.SpellAppliedFX	SpellAppliedFX	VespyrianMight	fxBlueWaterSplash,fx_f5_earthsphere_blue,fxBlueWaterSplash		
VeteranSilithar.UnitAttackedFX	UnitAttackedFX	VeteranSilithar	fxElectricalGroundUpBlue		
Vindicator.UnitAttackedFX	UnitAttackedFX	Vindicator	fxLightningHitGreen,fxElectricalGroundUpGreen		
VineEntangler.UnitAttackedFX	UnitAttackedFX	VineEntangler	fxCrossSlash,fxCrossSlash		
VoiceoftheWind.UnitAttackedFX	UnitAttackedFX	VoiceoftheWind	fxCollisionSparksBlue,fxLightningHitGreen,fxLightningHitGreen		
VoidHunter.UnitAttackedFX	UnitAttackedFX	VoidHunter	fxCollisionSparksBlue,fxElectricalGroundUpRed,fxClawSlash		
VoidSteal.SpellAppliedFX	SpellAppliedFX	VoidSteal	fx_f4_voidpulse		
VorpalReaver.UnitAttackedFX	UnitAttackedFX	VorpalReaver	fxCollisionSparksPurple,fxExplosionPurpleSmoke,fxExplosionPurpleSmoke,fxExplosionMediumBlueGround		
WarSurge.SpellCastFX	SpellCastFX	WarSurge	fx_f1_warsurge,fxYellowTeleporterBeam		
WarTalon.UnitAttackedFX	UnitAttackedFX	WarTalon	fxCollisionSparksBlue,fxPlasmaBlueHorizontal,fxPlasmaBlueHorizontal		
Warbird.SpellAppliedFX	SpellAppliedFX	Warbird	fxImpactBlueBig		
WhistlingBlade.UnitAttackedFX	UnitAttackedFX	WhistlingBlade	fxCollisionSparksBlue,fxElectricalGroundUpRed,fxElectricalGroundUpRed		
WhiteWidow.UnitAttackedFX	UnitAttackedFX	WhiteWidow	fxCollisionSparksPurple,fxCrossSlash,fxCrossSlash,fxExplosionMediumBlueGround		
Widowmaker.UnitAttackedFX	UnitAttackedFX	Widowmaker	f2RangedProjectile,fxExplosionMediumIcyWhite,fxCollisionSparksRed,fxCollisionSparksRed		
Widowmaker.impactFX	impactFX	Widowmaker	fxExplosionMediumIcyWhite,fxCollisionSparksRed,fxCollisionSparksRed		
WindRunner.UnitAttackedFX	UnitAttackedFX	WindRunner	fxCollisionSparksBlue,fxPlasmaBlueHorizontal,fxImpactRingVerticalWhite		
WindShrike.UnitAttackedFX	UnitAttackedFX	WindShrike	fxCollisionSparksOrange,fxImpactRingVerticalWhite,fxPlasmaBlueVertical		
WindShroud.SpellAppliedFX	SpellAppliedFX	WindShroud	fx_f3_bbs_ironshroud		
WindSister.UnitAttackedFX	UnitAttackedFX	WindSister	fxExplosionBigBall_MetalSlug		
WindbladeAdept.UnitAttackedFX	UnitAttackedFX	WindbladeAdept	fxImpactWhiteMedium,fxCollisionSparksBlue		
WindbladeCommander.UnitAttackedFX	UnitAttackedFX	WindbladeCommander	fxPlasmaBlueVertical,fxExplosionMediumBlueGround,fxCollisionSparksBlue,fxCollisionSparksBlue		
Windstopper.UnitAttackedFX	UnitAttackedFX	Windstopper	fxCollisionSparksBlue		
WingsOfParadise.UnitAttackedFX	UnitAttackedFX	WingsOfParadise	fxCollisionSparksRed,fxElectricalGroundUpBlue,fxElectricalGroundUpRed,fxElectricalGroundUpRed,fxElectricalGroundUpRed		
WintersWake.SpellCastFX	SpellCastFX	WintersWake	fx_f6_winterswake		
Wither.SpellAppliedFX	SpellAppliedFX	Wither	fx_ringswirl,fxTeleportRecall		
WolfAspect.UnitAttackedFX	UnitAttackedFX	WolfAspect	fxCollisionSparksBlue,fxDevour		
WolfRaven.UnitAttackedFX	UnitAttackedFX	WolfRaven	fxCollisionSparksOrange,fxClawSlash,fxClawSlash		
Wraithling.UnitAttackedFX	UnitAttackedFX	Wraithling	fxCrossSlash,fxCollisionSparksPurple		
WyrBeast.UnitAttackedFX	UnitAttackedFX	WyrBeast	fxCollisionSparksBlue,fxClawSlash,fxClawSlash		
Xho.UnitAttackedFX	UnitAttackedFX	Xho	fxExplosionOrangeSmoke,fxExplosionOrangeSmoke,fxImpactWhiteMedium		
XyleStormblade.UnitAttackedFX	UnitAttackedFX	XyleStormblade	fxPlasmaBlueVertical,fxCollisionSparksBlue,fxCollisionSparksBlue,fxExplosionMediumBlueGround		
YieldingDepths.SpellCastFX	SpellCastFX	YieldingDepths	fx_f4_shadownova		
YoungSilithar.UnitAttackedFX	UnitAttackedFX	YoungSilithar	fxCollisionSparksGreen,fxClawSlash		
Yun.UnitAttackedFX	UnitAttackedFX	Yun	fxCollisionSparksRed,fxImpactMediumOrange,fxImpactWhiteMedium		
ZenRui.UnitAttackedFX	UnitAttackedFX	ZenRui	fxCollisionSparksOrange,fxElectricalGroundUpYellow,fxImpactRingVerticalOrange,fxImpactRingVerticalOrange		
ZiranSunforge.UnitAttackedFX	UnitAttackedFX	ZiranSunforge	fxImpactRingVerticalOrange,fxCollisionSparksOrange,fxImpactRingVerticalWhite		
ZuraelTheLifegiver.UnitAttackedFX	UnitAttackedFX	ZuraelTheLifegiver	fx_fireslash,fxFireTornado,fxTeleportOrangeOrb,fx_f3_starsfury		
